Node	Total SNPs	Num of SNPs inside recombinations	Num of SNPs outside recombinations	Num of Recombination Blocks	Bases in Recombinations	r/m	rho/theta	Genome Length	Bases in Clonal Frame
ERR1204772	0	0	0	0	544513	0.000000	0.000000	2112638	1588433
ERR1204773	164	116	48	8	439132	2.416667	0.166667	2095334	1676293
ERR1204774	13	0	13	0	495368	0.000000	0.000000	2138023	1669666
ERR1204775	61	43	18	2	492411	2.388889	0.111111	2140750	1672590
ERR1204776	13	7	6	1	446311	1.166667	0.166667	2122836	1685959
ERR1204777	541	476	65	19	461439	7.323077	0.292308	2091324	1665818
ERR1204778	31	27	4	2	498913	6.750000	0.500000	2114799	1628177
ERR1204779	0	0	0	0	527441	0.000000	0.000000	2114159	1601225
ERR1204780	7	5	2	1	495368	2.500000	0.500000	2133697	1666629
ERR1204781	38	27	11	2	505107	2.454545	0.181818	2138063	1668565
ERR1204782	0	0	0	0	481410	0.000000	0.000000	2150766	1677937
ERR1204783	0	0	0	0	533018	0.000000	0.000000	2112593	1598195
ERR1204784	10	6	4	1	453724	1.500000	0.250000	2151600	1706548
ERR1204785	8	5	3	1	619407	1.666667	0.333333	2135047	1544518
ERR1204786	10	5	5	1	551853	1.000000	0.200000	2108443	1578286
ERR1204787	0	0	0	0	527441	0.000000	0.000000	2109939	1597197
ERR1204788	1774	876	898	26	491535	0.975501	0.028953	2113130	1653966
ERR1204789	62	40	22	5	556920	1.818182	0.227273	2154161	1609695
ERR1204790	175	154	21	4	478089	7.333333	0.190476	2138424	1677141
ERR1204791	468	410	58	10	529071	7.068965	0.172414	2106737	1612002
ERR1204792	457	323	134	13	372222	2.410448	0.097015	2146914	1810521
ERR1204793	0	0	0	0	495466	0.000000	0.000000	2136825	1667061
ERR1204794	24	10	14	2	507610	0.714286	0.142857	2105318	1612239
ERR1204795	129	104	25	2	540056	4.160000	0.080000	2160146	1639782
ERR1204796	737	463	274	20	494056	1.689781	0.072993	2128491	1671168
ERR1204797	9	7	2	1	495368	3.500000	0.500000	2137622	1669079
ERR1204798	31	0	31	0	420594	0.000000	0.000000	2153568	1738666
ERR1204801	49	24	25	3	445851	0.960000	0.120000	2140807	1705083
ERR1204802	0	0	0	0	522377	0.000000	0.000000	2111743	1599522
ERR1204803	0	0	0	0	437859	0.000000	0.000000	2092005	1670728
ERR1204804	14	0	14	0	448389	0.000000	0.000000	2158130	1717238
ERR1204805	0	0	0	0	483240	0.000000	0.000000	2110292	1642575
ERR1204806	21	21	0	2	459571	0.000000	0.000000	2155019	1704174
ERR1204807	134	109	25	3	543614	4.360000	0.120000	2133048	1618945
ERR1204812	17	14	3	2	424232	4.666667	0.666667	2147924	1738568
ERR1204813	0	0	0	0	529492	0.000000	0.000000	2113360	1602836
ERR2631822	5	0	5	0	525813	0.000000	0.000000	2125663	1619002
ERR2631824	103	49	54	4	435470	0.907407	0.074074	2131832	1715714
ERR2631828	16	0	16	0	619407	0.000000	0.000000	2126839	1536727
ERR2631829	0	0	0	0	459288	0.000000	0.000000	2108136	1659539
ERR2631830	47	22	25	2	619407	0.880000	0.080000	2133981	1543891
ERR2631731	65	5	60	1	455151	0.083333	0.016667	2066442	1628671
ERR2631831	555	421	134	17	427244	3.141791	0.126866	2124967	1762829
ERR2631833	2439	980	1459	31	261387	0.671693	0.021247	2142718	1930495
ERR2631834	0	0	0	0	508714	0.000000	0.000000	2180830	1678920
ERR2631835	0	0	0	0	500916	0.000000	0.000000	2095051	1613262
ERR2631836	12	0	12	0	500916	0.000000	0.000000	2099823	1617093
ERR2631837	0	0	0	0	520110	0.000000	0.000000	2105989	1605714
ERR2631838	40	0	40	0	387322	0.000000	0.000000	2101687	1738671
ERR2631840	7	7	0	1	519541	0.000000	0.000000	2110293	1612447
ERR2631732	3	0	3	0	491913	0.000000	0.000000	2142597	1671320
ERR2631841	60	45	15	4	451066	3.000000	0.266667	2142144	1700886
ERR2631843	293	211	82	9	451882	2.573171	0.109756	2140560	1710592
ERR2631844	0	0	0	0	508714	0.000000	0.000000	2181353	1679453
ERR2631845	0	0	0	0	521547	0.000000	0.000000	2104186	1601706
ERR2631846	61	0	61	0	427585	0.000000	0.000000	2132448	1719220
ERR2631847	5	0	5	0	619407	0.000000	0.000000	2126945	1539191
ERR2631848	0	0	0	0	619407	0.000000	0.000000	2129440	1539126
ERR2631849	1093	805	288	23	490780	2.795139	0.079861	2139326	1701855
ERR2631733	205	176	29	11	531914	6.068965	0.379310	2113183	1618204
ERR2631853	0	0	0	0	502548	0.000000	0.000000	2134361	1653821
ERR2631854	5	0	5	0	502548	0.000000	0.000000	2137683	1656431
ERR2631855	43	19	24	2	530943	0.791667	0.083333	2108260	1598829
ERR2631857	1422	1385	37	10	552218	37.432434	0.270270	2107935	1600283
ERR2631858	4	0	4	0	511774	0.000000	0.000000	2108470	1614411
ERR2631859	716	475	241	19	398511	1.970954	0.078838	2068182	1727273
ERR2631860	5	0	5	0	468669	0.000000	0.000000	2132255	1671221
ERR2631861	7	0	7	0	533018	0.000000	0.000000	2159798	1644814
ERR2631734	6	0	6	0	360798	0.000000	0.000000	2125518	1781750
ERR2631862	5	0	5	0	587273	0.000000	0.000000	2100700	1539682
ERR2631863	11	5	6	1	588093	0.833333	0.166667	2081732	1518445
ERR2631864	0	0	0	0	519432	0.000000	0.000000	2097770	1598713
ERR2631865	0	0	0	0	521089	0.000000	0.000000	2123494	1620784
ERR2631867	0	0	0	0	587020	0.000000	0.000000	2105178	1543993
ERR2631868	0	0	0	0	483243	0.000000	0.000000	2140835	1670404
ERR2631869	613	565	48	11	552380	11.770833	0.229167	2107628	1585229
ERR2631870	1503	1278	225	36	620837	5.680000	0.160000	2153176	1642809
ERR2631871	198	164	34	6	468106	4.823529	0.176471	2148737	1699727
ERR2631735	6	0	6	0	413739	0.000000	0.000000	2151581	1744188
ERR2631872	0	0	0	0	495368	0.000000	0.000000	2127501	1660610
ERR2631873	6	0	6	0	522539	0.000000	0.000000	2109841	1606447
ERR2631874	54	28	26	3	455602	1.076923	0.115385	2148096	1704416
ERR2631875	19	10	9	1	580749	1.111111	0.111111	2125439	1572295
ERR2631876	489	365	124	6	429353	2.943548	0.048387	2137203	1739143
ERR2631877	43	0	43	0	387322	0.000000	0.000000	2102522	1737899
ERR2631878	487	473	14	11	525316	33.785713	0.785714	2097108	1597588
ERR2631879	11	8	3	1	587277	2.666667	0.333333	2106428	1544926
ERR2631880	38	9	29	1	437859	0.310345	0.034483	2074921	1655255
ERR2631881	36	15	21	2	457279	0.714286	0.095238	2146097	1698128
ERR2631736	2	0	2	0	503038	0.000000	0.000000	2189986	1693110
ERR2631883	90	71	19	2	521299	3.736842	0.105263	2103814	1601568
ERR2631884	6	0	6	0	511774	0.000000	0.000000	2111110	1615696
ERR2631885	0	0	0	0	552515	0.000000	0.000000	2099887	1570620
ERR2631886	11	0	11	0	619407	0.000000	0.000000	2129652	1540342
ERR2631887	0	0	0	0	488837	0.000000	0.000000	2184785	1701423
ERR2631888	0	0	0	0	488837	0.000000	0.000000	2179056	1695690
ERR2631889	271	239	32	11	500331	7.468750	0.343750	2158862	1691844
ERR2631890	12	0	12	0	488024	0.000000	0.000000	2189556	1707539
ERR2631891	1435	1184	251	33	594266	4.717132	0.131474	2126912	1606939
ERR2631737	0	0	0	0	498925	0.000000	0.000000	2183848	1689614
ERR2631893	8	0	8	0	577304	0.000000	0.000000	2126195	1575818
ERR2631894	0	0	0	0	453645	0.000000	0.000000	2146651	1702371
ERR2631895	8	5	3	1	614204	1.666667	0.333333	2107523	1518173
ERR2631896	28	20	8	2	619521	2.500000	0.250000	2127825	1538294
ERR2631897	0	0	0	0	429058	0.000000	0.000000	2085359	1673591
ERR2631898	12	0	12	0	556386	0.000000	0.000000	2142399	1600920
ERR2631899	0	0	0	0	524263	0.000000	0.000000	2106752	1600381
ERR2631900	0	0	0	0	520938	0.000000	0.000000	2175013	1664166
ERR2631901	334	226	108	12	497093	2.092592	0.111111	2086842	1620986
ERR2631738	28	13	15	2	519656	0.866667	0.133333	2155133	1649155
ERR2631902	113	96	17	8	620117	5.647059	0.470588	2123952	1532282
ERR2631903	838	591	247	23	403251	2.392713	0.093117	2070227	1729316
ERR2631904	0	0	0	0	579193	0.000000	0.000000	2105522	1553590
ERR2631905	0	0	0	0	522539	0.000000	0.000000	2109883	1606601
ERR2631906	0	0	0	0	457607	0.000000	0.000000	2144568	1695853
ERR2631907	0	0	0	0	453645	0.000000	0.000000	2144791	1701136
ERR2631910	1	0	1	0	532808	0.000000	0.000000	2102071	1592154
ERR2631911	0	0	0	0	453645	0.000000	0.000000	2142049	1698435
ERR2631739	0	0	0	0	503038	0.000000	0.000000	2186047	1691086
ERR2631740	4	0	4	0	371979	0.000000	0.000000	2136986	1778231
ERR2631742	34	29	5	1	522539	5.800000	0.200000	2104485	1601256
ERR2631743	0	0	0	0	453645	0.000000	0.000000	2145828	1702303
ERR2631744	16	9	7	1	372020	1.285714	0.142857	2134314	1775219
ERR2631745	2	0	2	0	449150	0.000000	0.000000	2120600	1688440
ERR2631746	783	664	119	24	553310	5.579832	0.201681	2104755	1587443
ERR2631747	0	0	0	0	513624	0.000000	0.000000	2163074	1659222
ERR2631748	483	387	96	14	409715	4.031250	0.145833	2080668	1693045
ERR2631749	0	0	0	0	413739	0.000000	0.000000	2149003	1741831
ERR2631750	0	0	0	0	445940	0.000000	0.000000	2143933	1709565
ERR2631723	0	0	0	0	456819	0.000000	0.000000	2139181	1701343
ERR2631751	58	43	15	3	453416	2.866667	0.200000	2149416	1714741
ERR2631752	8	7	1	1	453645	7.000000	1.000000	2144822	1700106
ERR2631753	0	0	0	0	413739	0.000000	0.000000	2147248	1739685
ERR2631754	0	0	0	0	524145	0.000000	0.000000	2173192	1660210
ERR2631755	92	84	8	3	482010	10.500000	0.375000	2191561	1715784
ERR2631756	27	19	8	2	532808	2.375000	0.250000	2100917	1591094
ERR2631757	0	0	0	0	518770	0.000000	0.000000	2098867	1600522
ERR2631758	11	0	11	0	446311	0.000000	0.000000	2115950	1680183
ERR2631759	20	4	16	1	532783	0.250000	0.062500	2096764	1588942
ERR2631760	43	0	43	0	448389	0.000000	0.000000	2149439	1710648
ERR2631724	18	4	14	1	521089	0.285714	0.071429	2123205	1621106
ERR2631761	0	0	0	0	619407	0.000000	0.000000	2130044	1538918
ERR2631762	13	5	8	1	409886	0.625000	0.125000	2142682	1746017
ERR2631763	6	0	6	0	409886	0.000000	0.000000	2140271	1743826
ERR2631764	0	0	0	0	501857	0.000000	0.000000	2178151	1686308
ERR2631765	560	466	94	15	442400	4.957447	0.159574	2146947	1727271
ERR2631766	0	0	0	0	441809	0.000000	0.000000	2146981	1715656
ERR2631767	846	794	52	20	484290	15.269231	0.384615	2144578	1714219
ERR2631768	5	5	0	1	371979	0.000000	0.000000	2137782	1778378
ERR2631769	1142	969	173	28	484256	5.601156	0.161850	2088535	1676582
ERR2631770	0	0	0	0	413739	0.000000	0.000000	2144920	1737996
ERR2631725	539	464	75	17	516523	6.186666	0.226667	2188711	1707236
ERR2631771	222	204	18	9	455463	11.333333	0.500000	2144605	1708728
ERR2631772	0	0	0	0	451485	0.000000	0.000000	2148489	1706112
ERR2631773	235	205	30	7	497950	6.833333	0.233333	2136720	1657624
ERR2631774	296	253	43	11	546538	5.883721	0.255814	2100138	1589155
ERR2631775	93	86	7	1	525813	12.285714	0.142857	2119519	1615207
ERR2631776	0	0	0	0	527441	0.000000	0.000000	2103953	1593975
ERR2631777	98	82	16	3	511317	5.125000	0.187500	2105447	1621732
ERR2631778	43	21	22	2	576118	0.954545	0.090909	2105593	1557462
ERR2631779	5	5	0	1	527188	0.000000	0.000000	2101992	1595750
ERR2631780	0	0	0	0	483353	0.000000	0.000000	2185938	1708993
ERR2631781	11	5	6	1	529379	0.833333	0.166667	2111841	1600529
ERR2631782	0	0	0	0	415941	0.000000	0.000000	2143794	1735007
ERR2631783	11	11	0	1	538009	0.000000	0.000000	2109507	1588597
ERR2631784	198	157	41	10	529229	3.829268	0.243902	2105328	1603461
ERR2631785	8	6	2	1	389437	3.000000	0.500000	2146205	1771978
ERR2631786	69	22	47	3	448389	0.468085	0.063830	2150184	1711452
ERR2631727	0	0	0	0	556386	0.000000	0.000000	2145606	1602133
ERR2631794	217	172	45	14	468728	3.822222	0.311111	2081524	1645670
ERR2631795	14	4	10	1	417308	0.400000	0.100000	2141504	1734058
ERR2631796	384	331	53	18	407269	6.245283	0.339623	2146690	1777011
ERR2631797	0	0	0	0	502058	0.000000	0.000000	2097771	1616486
ERR2631798	129	118	11	4	520420	10.727273	0.363636	2171435	1680461
ERR2631799	1	0	1	0	495368	0.000000	0.000000	2131158	1662624
ERR2631800	0	0	0	0	544976	0.000000	0.000000	2103405	1581142
ERR2631728	0	0	0	0	442976	0.000000	0.000000	2111682	1674798
ERR2631801	1	0	1	0	544976	0.000000	0.000000	2101913	1578631
ERR2631802	0	0	0	0	497301	0.000000	0.000000	2133177	1653833
ERR2631803	0	0	0	0	501857	0.000000	0.000000	2177625	1684813
ERR2631807	715	527	188	18	502140	2.803191	0.095745	2116375	1642284
ERR2631808	0	0	0	0	531971	0.000000	0.000000	2104548	1593102
ERR2631809	197	111	86	7	534940	1.290698	0.081395	2093918	1585938
ERR2631810	4	0	4	0	492411	0.000000	0.000000	2131142	1663624
ERR2631729	4	0	4	0	539557	0.000000	0.000000	2110260	1586590
ERR2631811	0	0	0	0	527264	0.000000	0.000000	2126983	1622146
ERR2631812	0	0	0	0	416946	0.000000	0.000000	2139683	1734882
ERR2631813	997	727	270	26	518458	2.692593	0.096296	2127078	1668639
ERR2631814	28	5	23	1	429681	0.217391	0.043478	2130308	1714984
ERR2631815	1	0	1	0	451485	0.000000	0.000000	2149664	1707724
ERR2631816	0	0	0	0	614204	0.000000	0.000000	2106327	1516975
ERR2631817	0	0	0	0	486108	0.000000	0.000000	2142278	1671876
ERR2631818	0	0	0	0	574702	0.000000	0.000000	2176185	1612833
ERR2631819	3310	1652	1658	33	376805	0.996381	0.019903	2135778	1840503
ERR2631730	0	0	0	0	538009	0.000000	0.000000	2108658	1587831
ERR2632011	135	112	23	3	489238	4.869565	0.130435	2156861	1684498
ERR2632012	0	0	0	0	448389	0.000000	0.000000	2145660	1706682
ERR2632013	5	0	5	0	423181	0.000000	0.000000	2150557	1737748
ERR2632014	0	0	0	0	449150	0.000000	0.000000	2119545	1686554
ERR2632015	0	0	0	0	529312	0.000000	0.000000	2107085	1592070
ERR2632016	32	13	19	2	511653	0.684211	0.105263	2110866	1615169
ERR2632017	7	5	2	1	519432	2.500000	0.500000	2095318	1598950
ERR2632018	8	0	8	0	538832	0.000000	0.000000	2107215	1586748
ERR2632019	1	0	1	0	524925	0.000000	0.000000	2106771	1602120
ERR2632020	1367	1138	229	22	590597	4.969432	0.096070	2105381	1623482
ERR2631921	0	0	0	0	529150	0.000000	0.000000	2100062	1592601
ERR2632021	320	164	156	6	429234	1.051282	0.038462	2126878	1717474
ERR2632022	1250	980	270	33	515372	3.629630	0.122222	2118668	1700426
ERR2632026	28	10	18	2	484531	0.555556	0.111111	2137778	1671197
ERR2632028	1	0	1	0	352555	0.000000	0.000000	2087446	1748571
ERR2631922	17	11	6	1	429058	1.833333	0.166667	2081355	1670464
ERR2632033	0	0	0	0	577304	0.000000	0.000000	2133325	1580106
ERR2632034	0	0	0	0	577304	0.000000	0.000000	2134555	1580599
ERR2632035	3	0	3	0	623863	0.000000	0.000000	2127522	1532793
ERR2632036	153	117	36	3	497590	3.250000	0.083333	2099914	1618787
ERR2632037	105	97	8	7	486150	12.125000	0.875000	2183693	1707159
ERR2632038	4	0	4	0	518171	0.000000	0.000000	2099327	1598072
ERR2632039	32	6	26	1	519758	0.230769	0.038462	2104264	1605723
ERR2632040	7	0	7	0	588093	0.000000	0.000000	2081061	1515680
ERR2631923	14	6	8	1	481440	0.750000	0.125000	2144197	1672927
ERR2632041	352	326	26	7	524245	12.538462	0.269231	2104939	1605320
ERR2632042	203	185	18	6	487344	10.277778	0.333333	2105323	1639228
ERR2632043	0	0	0	0	538383	0.000000	0.000000	2105945	1587088
ERR2632044	33	33	0	2	538383	0.000000	0.000000	2105162	1586703
ERR2631924	5	0	5	0	435395	0.000000	0.000000	2144464	1716541
ERR2631925	51	6	45	1	468999	0.133333	0.022222	2107894	1652095
ERR2631926	0	0	0	0	532808	0.000000	0.000000	2100807	1590665
ERR2631927	775	665	110	22	556475	6.045455	0.200000	2102700	1619700
ERR2631928	0	0	0	0	472781	0.000000	0.000000	2187741	1720389
ERR2631929	0	0	0	0	564686	0.000000	0.000000	2128978	1588272
ERR2631930	0	0	0	0	472781	0.000000	0.000000	2185260	1718621
ERR2631912	53	35	18	2	507545	1.944444	0.111111	2135975	1654668
ERR2631931	117	81	36	5	532953	2.250000	0.138889	2106497	1592670
ERR2631932	13	0	13	0	478664	0.000000	0.000000	2146370	1677117
ERR2631933	262	232	30	5	388319	7.733333	0.166667	2116083	1752654
ERR2631934	0	0	0	0	423181	0.000000	0.000000	2149102	1735692
ERR2631935	0	0	0	0	518646	0.000000	0.000000	2179608	1668768
ERR2631936	193	155	38	5	479280	4.078948	0.131579	2102761	1643285
ERR2631937	108	78	30	2	425235	2.600000	0.066667	2136043	1725291
ERR2631938	0	0	0	0	413739	0.000000	0.000000	2145118	1737489
ERR2631939	6	0	6	0	413739	0.000000	0.000000	2145810	1738476
ERR2631913	995	743	252	30	419117	2.948413	0.119048	2132136	1764341
ERR2631941	0	0	0	0	556476	0.000000	0.000000	2105350	1567694
ERR2631942	147	121	26	9	586535	4.653846	0.346154	2135845	1582615
ERR2631947	15	9	6	1	482010	1.500000	0.166667	2189970	1714090
ERR2631949	2	0	2	0	619407	0.000000	0.000000	2134052	1542203
ERR2631950	40	21	19	3	452366	1.105263	0.157895	2149089	1705753
ERR2631914	0	0	0	0	429058	0.000000	0.000000	2082131	1671287
ERR2631951	0	0	0	0	495368	0.000000	0.000000	2131076	1662917
ERR2631952	12	6	6	1	511130	1.000000	0.166667	2126141	1629553
ERR2631953	0	0	0	0	442747	0.000000	0.000000	2077103	1657004
ERR2631954	5	0	5	0	478475	0.000000	0.000000	2144770	1674354
ERR2631955	10	0	10	0	442246	0.000000	0.000000	2080027	1656856
ERR2631956	1	0	1	0	429058	0.000000	0.000000	2085541	1674345
ERR2631957	0	0	0	0	522539	0.000000	0.000000	2104015	1603473
ERR2631958	0	0	0	0	449614	0.000000	0.000000	2142210	1703200
ERR2631959	0	0	0	0	533018	0.000000	0.000000	2156633	1640335
ERR2631960	31	19	12	2	568185	1.583333	0.166667	2107777	1577086
ERR2631915	1153	943	210	23	584967	4.490476	0.109524	2105711	1590606
ERR2631962	7	6	1	1	413739	6.000000	1.000000	2144005	1737214
ERR2631963	268	174	94	8	537118	1.851064	0.085106	2102791	1606143
ERR2631964	10	0	10	0	423181	0.000000	0.000000	2148631	1734042
ERR2631965	1	0	1	0	501857	0.000000	0.000000	2178371	1686075
ERR2631966	0	0	0	0	552515	0.000000	0.000000	2099844	1571327
ERR2631967	4	0	4	0	539557	0.000000	0.000000	2107309	1584649
ERR2631968	2	0	2	0	619407	0.000000	0.000000	2128389	1539360
ERR2631969	546	499	47	6	473945	10.617022	0.127660	2140496	1703187
ERR2631970	5	0	5	0	501090	0.000000	0.000000	2174089	1682225
ERR2631916	39	33	6	3	421204	5.500000	0.500000	2151808	1737411
ERR2631971	6	0	6	0	501857	0.000000	0.000000	2175535	1683541
ERR2631972	39	27	12	2	520938	2.250000	0.166667	2171185	1660189
ERR2631973	2	0	2	0	330304	0.000000	0.000000	2093705	1776970
ERR2631974	0	0	0	0	463605	0.000000	0.000000	2145960	1702956
ERR2631975	50	34	16	2	516348	2.125000	0.125000	2126271	1627740
ERR2631976	0	0	0	0	435395	0.000000	0.000000	2146046	1716769
ERR2631977	0	0	0	0	498913	0.000000	0.000000	2103379	1620404
ERR2631978	0	0	0	0	463605	0.000000	0.000000	2144458	1700473
ERR2631979	63	46	17	3	384000	2.705882	0.176471	2137379	1761000
ERR2631980	1678	1408	270	35	514179	5.214815	0.129630	2190200	1735976
ERR2631917	117	113	4	7	539015	28.250000	1.750000	2114104	1601444
ERR2631981	1169	887	282	30	481983	3.145390	0.106383	2110280	1689133
ERR2631982	0	0	0	0	619521	0.000000	0.000000	2131519	1541024
ERR2631983	78	55	23	3	507989	2.391304	0.130435	2173943	1675042
ERR2631984	0	0	0	0	562974	0.000000	0.000000	2127820	1583946
ERR2631985	0	0	0	0	482010	0.000000	0.000000	2187967	1711893
ERR2631986	0	0	0	0	448477	0.000000	0.000000	2148080	1710311
ERR2631987	1	0	1	0	330304	0.000000	0.000000	2098538	1779785
ERR2631988	0	0	0	0	330304	0.000000	0.000000	2102272	1783972
ERR2631989	13	0	13	0	524145	0.000000	0.000000	2173592	1660255
ERR2631918	1321	1092	229	24	478020	4.768559	0.104803	2094585	1677291
ERR2631991	0	0	0	0	478664	0.000000	0.000000	2146301	1676943
ERR2631992	0	0	0	0	330304	0.000000	0.000000	2099681	1780977
ERR2631993	266	251	15	5	559318	16.733334	0.333333	2111594	1591640
ERR2631994	0	0	0	0	441809	0.000000	0.000000	2145428	1715707
ERR2631995	6	5	1	1	519541	5.000000	1.000000	2109687	1610962
ERR2631996	341	211	130	12	528343	1.623077	0.092308	2106314	1602519
ERR2631997	8	6	2	1	482010	3.000000	0.500000	2189704	1714618
ERR2631998	2380	1790	590	40	512095	3.033898	0.067797	2096577	1697021
ERR2631999	714	548	166	22	395050	3.301205	0.132530	2089519	1732464
ERR2632000	2130	1347	783	37	500092	1.720307	0.047254	2096093	1642853
ERR2631919	0	0	0	0	532808	0.000000	0.000000	2102466	1593679
ERR2632001	2	0	2	0	524925	0.000000	0.000000	2109554	1603690
ERR2632002	218	213	5	3	495357	42.599998	0.600000	2192396	1707151
ERR2632003	118	94	24	7	478276	3.916667	0.291667	2107523	1644756
ERR2632004	78	76	2	2	501924	38.000000	1.000000	2101253	1612182
ERR2632005	11	0	11	0	518171	0.000000	0.000000	2098970	1598784
ERR2632006	0	0	0	0	423240	0.000000	0.000000	2139405	1728451
ERR2632007	0	0	0	0	538980	0.000000	0.000000	2108481	1591382
ERR2632008	97	42	55	6	450169	0.763636	0.109091	2104343	1675272
ERR2632009	586	458	128	21	512119	3.578125	0.164062	2103693	1610867
ERR2632010	159	101	58	5	623863	1.741379	0.086207	2130042	1533224
ERR2631920	110	60	50	6	448389	1.200000	0.120000	2146286	1707442
ERR1837103	0	0	0	0	524037	0.000000	0.000000	2138633	1631624
ERR1837104	0	0	0	0	527264	0.000000	0.000000	2143776	1634798
ERR1837105	5	0	5	0	520938	0.000000	0.000000	2188683	1676802
ERR1837106	13	8	5	1	429326	1.600000	0.200000	2136052	1718142
ERR1837107	1	0	1	0	492611	0.000000	0.000000	2080211	1601165
ERR1837109	26	21	5	3	536845	4.200000	0.600000	2151217	1625285
ERR1837110	0	0	0	0	412356	0.000000	0.000000	2145358	1748392
ERR1837111	5	5	0	1	442802	0.000000	0.000000	2097246	1674382
ERR1837112	26	0	26	0	428396	0.000000	0.000000	2150042	1734847
ERR1837113	1151	583	568	21	352934	1.026408	0.036972	2151152	1827998
ERR1837114	190	131	59	7	440012	2.220339	0.118644	2142152	1712518
ERR1837115	213	152	61	10	543296	2.491803	0.163934	2119087	1592528
ERR1837116	0	0	0	0	516348	0.000000	0.000000	2135548	1633071
ERR1837117	3	0	3	0	462125	0.000000	0.000000	2090226	1648510
ERR1837118	10	0	10	0	557098	0.000000	0.000000	2121173	1582420
ERR1837119	8	7	1	1	524037	7.000000	1.000000	2136449	1629669
ERR1837120	0	0	0	0	518171	0.000000	0.000000	2112428	1609087
ERR1837121	9	7	2	1	485637	3.500000	0.500000	2189668	1713555
ERR1837122	6	0	6	0	544113	0.000000	0.000000	2114612	1587818
ERR1837123	0	0	0	0	443021	0.000000	0.000000	2093969	1670738
ERR1837125	0	0	0	0	534255	0.000000	0.000000	2134979	1620091
ERR1837126	3	0	3	0	492611	0.000000	0.000000	2082553	1603259
ERR1837127	169	129	40	9	439748	3.225000	0.225000	2137299	1719574
ERR1837128	3	0	3	0	557917	0.000000	0.000000	2184358	1635920
ERR1837129	8	0	8	0	521877	0.000000	0.000000	2112494	1610152
ERR1837130	0	0	0	0	536845	0.000000	0.000000	2148661	1622917
ERR1837131	5	0	5	0	540191	0.000000	0.000000	2124961	1600186
ERR1837132	111	55	56	5	489375	0.982143	0.089286	2145870	1671058
ERR1837133	0	0	0	0	525813	0.000000	0.000000	2137911	1628659
ERR2632045	0	0	0	0	534255	0.000000	0.000000	2136280	1621561
ERR1837102	75	68	7	5	510539	9.714286	0.714286	2119389	1623086
ERR3200821	1212	1081	131	29	503869	8.251908	0.221374	2157602	1715672
ERR3200822	13	6	7	1	533839	0.857143	0.142857	2114932	1600658
ERR3200824	1	0	1	0	568275	0.000000	0.000000	2131226	1583538
ERR3200825	21	11	10	1	501142	1.100000	0.100000	2112242	1627818
ERR3200826	2	0	2	0	446982	0.000000	0.000000	2123390	1695034
ERR3200860	473	401	72	12	461688	5.569445	0.166667	2149717	1709086
ERR3200861	0	0	0	0	560590	0.000000	0.000000	2109621	1570336
ERR3200862	97	67	30	4	522984	2.233333	0.133333	2113593	1609735
ERR3200863	34	29	5	4	444975	5.800000	0.800000	2150481	1713846
ERR3200864	219	184	35	9	437783	5.257143	0.257143	2088355	1676937
ERR3200865	12	5	7	1	527343	0.714286	0.142857	2138751	1629980
ERR3200866	9	0	9	0	623019	0.000000	0.000000	2139893	1539088
ERR3200827	97	86	11	2	521625	7.818182	0.181818	2113121	1606943
ERR3200867	35	25	10	2	415941	2.500000	0.200000	2155908	1745171
ERR3200868	0	0	0	0	578884	0.000000	0.000000	2100734	1541089
ERR3200869	0	0	0	0	448406	0.000000	0.000000	2152399	1713614
ERR3200870	0	0	0	0	534630	0.000000	0.000000	2118836	1602987
ERR3200871	0	0	0	0	525813	0.000000	0.000000	2132637	1625312
ERR3200872	0	0	0	0	571797	0.000000	0.000000	2172239	1609587
ERR3200873	4253	2065	2188	46	329326	0.943784	0.021024	2140864	1894031
ERR3200874	255	231	24	5	504420	9.625000	0.208333	2080927	1608379
ERR3200875	17	0	17	0	371423	0.000000	0.000000	2145687	1786577
ERR3200876	170	168	2	3	391861	84.000000	1.500000	2152633	1775458
ERR3200828	10	5	5	1	502548	1.000000	0.200000	2145733	1663780
ERR3200877	505	476	29	11	525405	16.413794	0.379310	2111991	1616425
ERR3200878	446	357	89	10	514222	4.011236	0.112360	2144109	1671039
ERR3200879	81	64	17	4	522640	3.764706	0.235294	2110472	1606422
ERR3200880	0	0	0	0	518171	0.000000	0.000000	2105929	1602840
ERR3200881	0	0	0	0	473073	0.000000	0.000000	2132177	1668776
ERR3200882	0	0	0	0	619407	0.000000	0.000000	2135021	1541969
ERR3200883	0	0	0	0	623863	0.000000	0.000000	2131484	1536153
ERR3200884	0	0	0	0	529352	0.000000	0.000000	2114371	1594739
ERR3200885	178	58	120	4	472478	0.483333	0.033333	2129935	1674025
ERR3200886	0	0	0	0	509215	0.000000	0.000000	2136287	1643249
ERR3200829	2	0	2	0	446982	0.000000	0.000000	2122820	1694304
ERR3200888	0	0	0	0	556476	0.000000	0.000000	2109243	1572472
ERR3200889	397	348	49	7	473558	7.102041	0.142857	2089803	1650752
ERR3200890	0	0	0	0	522230	0.000000	0.000000	2112185	1609125
ERR3200891	0	0	0	0	577592	0.000000	0.000000	2139217	1585239
ERR3200892	211	121	90	9	451873	1.344444	0.100000	2121365	1685017
ERR3200893	55	24	31	3	484577	0.774194	0.096774	2139091	1670222
ERR3200894	0	0	0	0	511899	0.000000	0.000000	2188519	1680365
ERR3200895	1	0	1	0	511899	0.000000	0.000000	2189319	1680793
ERR3200896	0	0	0	0	486893	0.000000	0.000000	2152596	1673230
ERR3200830	77	66	11	4	396858	6.000000	0.363636	2149475	1771193
ERR3200812	3	0	3	0	468669	0.000000	0.000000	2140491	1678519
ERR3200897	0	0	0	0	522539	0.000000	0.000000	2115353	1612015
ERR3200898	71	36	35	5	555175	1.028571	0.142857	2112820	1584498
ERR3200899	615	568	47	18	501871	12.085107	0.382979	2122784	1688422
ERR3200900	0	0	0	0	518646	0.000000	0.000000	2187037	1674992
ERR3200901	1082	806	276	23	493408	2.920290	0.083333	2135363	1662132
ERR3200902	4	0	4	0	518770	0.000000	0.000000	2105750	1606708
ERR3200903	354	339	15	4	506927	22.600000	0.266667	2104877	1624941
ERR3200904	470	309	161	16	418063	1.919255	0.099379	2133667	1770815
ERR3200905	183	30	153	4	420175	0.196078	0.026144	2141540	1735169
ERR3200906	383	335	48	6	623863	6.979167	0.125000	2134406	1537648
ERR3200831	0	0	0	0	511559	0.000000	0.000000	2180317	1677978
ERR3200907	647	429	218	17	493688	1.967890	0.077982	2123788	1671954
ERR3200908	20	9	11	2	532808	0.818182	0.181818	2109886	1598353
ERR3200909	0	0	0	0	533018	0.000000	0.000000	2164425	1647617
ERR3200910	100	84	16	5	454808	5.250000	0.312500	2149178	1713908
ERR3200911	0	0	0	0	568275	0.000000	0.000000	2120965	1573300
ERR3200912	13	7	6	1	511130	1.166667	0.166667	2133780	1634312
ERR3200913	493	253	240	10	436313	1.054167	0.041667	2137019	1738016
ERR3200914	0	0	0	0	442246	0.000000	0.000000	2087993	1663529
ERR3200915	4	0	4	0	532917	0.000000	0.000000	2107821	1595427
ERR3200916	0	0	0	0	471861	0.000000	0.000000	2130978	1670555
ERR3200832	4	0	4	0	511559	0.000000	0.000000	2180345	1678338
ERR3200917	4	0	4	0	501857	0.000000	0.000000	2186404	1691145
ERR3200918	295	217	78	13	493366	2.782051	0.166667	2090929	1624858
ERR3200919	4	0	4	0	492411	0.000000	0.000000	2138512	1671303
ERR3200920	1351	839	512	28	494399	1.638672	0.054688	2136920	1677614
ERR3200921	0	0	0	0	529150	0.000000	0.000000	2105316	1597218
ERR3200922	9	0	9	0	510539	0.000000	0.000000	2110120	1616172
ERR3200923	558	468	90	23	487475	5.200000	0.255556	2121869	1680209
ERR3200924	0	0	0	0	532888	0.000000	0.000000	2107956	1593629
ERR3200925	0	0	0	0	497301	0.000000	0.000000	2136335	1655679
ERR3200926	324	282	42	9	451439	6.714286	0.214286	2088053	1663885
ERR3200833	0	0	0	0	521842	0.000000	0.000000	2118417	1616222
ERR3200927	0	0	0	0	491913	0.000000	0.000000	2142304	1672508
ERR3200928	750	506	244	22	417467	2.073771	0.090164	2139041	1784200
ERR3200929	263	248	15	9	567315	16.533333	0.600000	2111891	1584840
ERR3200930	639	485	154	17	445030	3.149351	0.110390	2133904	1723930
ERR3200931	757	647	110	22	564277	5.881818	0.200000	2158565	1674357
ERR3200932	0	0	0	0	518171	0.000000	0.000000	2107682	1604769
ERR3200933	1	0	1	0	413739	0.000000	0.000000	2152553	1743939
ERR3200934	120	77	43	5	485029	1.790698	0.116279	2150372	1680918
ERR3200935	58	43	15	4	447756	2.866667	0.266667	2089890	1666236
ERR3200936	2013	1507	506	32	449789	2.978261	0.063241	2144245	1819923
ERR3200834	1	0	1	0	532808	0.000000	0.000000	2108896	1596451
ERR3200937	1	0	1	0	501857	0.000000	0.000000	2184835	1690346
ERR3200938	36	0	36	0	413739	0.000000	0.000000	2150752	1742532
ERR3200939	0	0	0	0	500534	0.000000	0.000000	2104302	1614158
ERR3200940	0	0	0	0	413739	0.000000	0.000000	2149765	1741673
ERR3200941	3	0	3	0	518771	0.000000	0.000000	2109098	1608219
ERR3200942	4	0	4	0	413739	0.000000	0.000000	2148382	1740369
ERR3200943	3	0	3	0	532808	0.000000	0.000000	2101761	1591316
ERR3200944	122	103	19	9	541254	5.421052	0.473684	2108964	1587560
ERR3200945	0	0	0	0	532808	0.000000	0.000000	2105193	1593760
ERR3200946	507	429	78	7	513252	5.500000	0.089744	2100110	1614399
ERR3200835	9	0	9	0	482010	0.000000	0.000000	2198068	1722372
ERR3200947	21	8	13	1	619407	0.615385	0.076923	2131660	1539122
ERR3200948	0	0	0	0	486011	0.000000	0.000000	2190271	1712924
ERR3200949	216	187	29	10	533468	6.448276	0.344828	2114255	1607360
ERR3200951	119	97	22	5	491577	4.409091	0.227273	2199727	1714708
ERR3200952	0	0	0	0	409326	0.000000	0.000000	2150680	1756613
ERR3200954	0	0	0	0	537261	0.000000	0.000000	2163434	1643464
ERR3200955	0	0	0	0	566809	0.000000	0.000000	2112605	1580366
ERR3200956	89	41	48	3	527264	0.854167	0.062500	2136229	1629729
ERR3200836	34	26	8	2	417497	3.250000	0.250000	2151137	1742154
ERR3200957	0	0	0	0	448389	0.000000	0.000000	2153401	1713987
ERR3200958	8	0	8	0	577304	0.000000	0.000000	2132976	1581803
ERR3200959	43	5	38	1	428340	0.131579	0.026316	2134754	1719827
ERR3200960	4	0	4	0	431298	0.000000	0.000000	2147331	1725839
ERR3200961	0	0	0	0	442872	0.000000	0.000000	2151119	1715388
ERR3200962	8	6	2	1	619407	3.000000	0.500000	2133588	1541703
ERR3200964	0	0	0	0	431298	0.000000	0.000000	2146302	1725368
ERR3200965	2	0	2	0	533555	0.000000	0.000000	2117898	1605015
ERR3200966	0	0	0	0	532888	0.000000	0.000000	2118050	1603468
ERR3200837	28	0	28	0	498127	0.000000	0.000000	2187829	1697699
ERR3200967	0	0	0	0	485481	0.000000	0.000000	2183068	1707305
ERR3200968	1372	1128	244	25	519212	4.622951	0.102459	2100019	1646432
ERR3200969	0	0	0	0	482989	0.000000	0.000000	2124095	1645879
ERR3200970	0	0	0	0	448389	0.000000	0.000000	2151671	1711090
ERR3200971	9	0	9	0	522119	0.000000	0.000000	2110748	1600140
ERR3200972	2	0	2	0	619407	0.000000	0.000000	2134194	1542401
ERR3200973	306	228	78	13	494301	2.923077	0.166667	2114610	1642283
ERR3200974	0	0	0	0	547416	0.000000	0.000000	2144594	1603586
ERR3200975	0	0	0	0	518171	0.000000	0.000000	2109141	1609749
ERR3200976	0	0	0	0	486389	0.000000	0.000000	2198838	1717067
ERR3200838	17	6	11	1	478677	0.545455	0.090909	2086127	1621840
ERR3200977	5	0	5	0	518769	0.000000	0.000000	2108931	1608357
ERR3200978	0	0	0	0	573507	0.000000	0.000000	2115855	1560970
ERR3200979	12	0	12	0	532071	0.000000	0.000000	2108108	1595552
ERR3200980	92	69	23	8	535437	3.000000	0.347826	2132699	1621447
ERR3200981	914	536	378	27	382913	1.417989	0.071429	2134944	1818250
ERR3200982	281	222	59	7	498704	3.762712	0.118644	2133507	1652201
ERR3200983	0	0	0	0	486546	0.000000	0.000000	2155586	1682911
ERR3200984	178	119	59	10	517831	2.016949	0.169492	2113782	1616854
ERR3200985	2	0	2	0	532888	0.000000	0.000000	2106770	1593261
ERR3200986	15	13	2	2	522586	6.500000	1.000000	2110374	1607245
ERR3200839	16	0	16	0	500916	0.000000	0.000000	2109441	1626646
ERR3200987	127	104	23	7	457443	4.521739	0.304348	2148647	1718727
ERR3200988	1	0	1	0	524263	0.000000	0.000000	2115508	1608585
ERR3200989	0	0	0	0	524264	0.000000	0.000000	2111472	1606218
ERR3200990	0	0	0	0	501388	0.000000	0.000000	2179187	1686904
ERR3200991	2	0	2	0	413739	0.000000	0.000000	2151504	1743194
ERR3200992	4	0	4	0	521877	0.000000	0.000000	2111617	1609660
ERR3200993	9	0	9	0	518171	0.000000	0.000000	2108308	1605595
ERR3200994	0	0	0	0	476213	0.000000	0.000000	2172346	1701366
ERR3200995	144	102	42	4	439507	2.428571	0.095238	2088981	1675623
ERR3200996	1140	1079	61	25	602701	17.688524	0.409836	2168020	1602095
ERR3200840	0	0	0	0	527264	0.000000	0.000000	2135326	1629106
ERR3200813	0	0	0	0	389437	0.000000	0.000000	2149281	1773194
ERR3200997	169	153	16	6	522539	9.562500	0.375000	2115011	1612366
ERR3200998	53	37	16	2	529968	2.312500	0.125000	2134664	1626497
ERR3200999	8	6	2	1	435395	3.000000	0.500000	2149653	1719783
ERR3201000	1	0	1	0	528973	0.000000	0.000000	2103023	1596356
ERR3201001	2	0	2	0	445750	0.000000	0.000000	2142604	1706816
ERR3201002	0	0	0	0	445750	0.000000	0.000000	2142606	1708624
ERR3201003	0	0	0	0	511559	0.000000	0.000000	2174919	1673099
ERR3201004	264	235	29	11	571833	8.103448	0.379310	2117752	1592530
ERR3201005	4	0	4	0	413739	0.000000	0.000000	2149410	1741399
ERR3201006	0	0	0	0	556399	0.000000	0.000000	2149802	1605806
ERR3200841	0	0	0	0	537489	0.000000	0.000000	2118480	1598248
ERR3201007	0	0	0	0	528973	0.000000	0.000000	2103656	1595440
ERR3201008	0	0	0	0	384083	0.000000	0.000000	2143837	1768884
ERR3201009	172	146	26	7	446618	5.615385	0.269231	2144701	1723769
ERR3201010	2	0	2	0	556476	0.000000	0.000000	2106543	1570836
ERR3201011	1485	1294	191	32	529201	6.774869	0.167539	2145780	1743919
ERR3201012	25	22	3	2	521341	7.333333	0.666667	2114702	1616054
ERR3201013	0	0	0	0	516899	0.000000	0.000000	2115795	1619132
ERR3201014	0	0	0	0	524263	0.000000	0.000000	2113300	1608082
ERR3201015	0	0	0	0	538009	0.000000	0.000000	2113161	1592770
ERR3201016	1	0	1	0	524925	0.000000	0.000000	2110595	1604761
ERR3200842	1	0	1	0	502548	0.000000	0.000000	2138625	1656339
ERR3201017	34	20	14	3	545392	1.428571	0.214286	2112650	1585020
ERR3201018	52	9	43	2	427694	0.209302	0.046512	2136767	1721630
ERR3201019	0	0	0	0	511950	0.000000	0.000000	2108065	1614395
ERR3201020	0	0	0	0	527333	0.000000	0.000000	2114142	1605651
ERR3200843	1	0	1	0	526686	0.000000	0.000000	2103503	1599708
ERR3200844	70	40	30	4	520806	1.333333	0.133333	2135282	1633998
ERR3200845	8	0	8	0	476496	0.000000	0.000000	2115076	1652367
ERR3200846	141	110	31	9	367018	3.548387	0.290323	2138998	1781996
ERR3200847	8	0	8	0	451763	0.000000	0.000000	2154521	1711312
ERR3200848	0	0	0	0	527188	0.000000	0.000000	2113474	1607701
ERR3200849	0	0	0	0	531264	0.000000	0.000000	2146156	1627993
ERR3200850	13	0	13	0	429058	0.000000	0.000000	2093816	1682334
ERR3200814	1707	1016	691	22	422477	1.470333	0.031838	2143730	1768930
ERR3200851	200	125	75	10	528185	1.666667	0.133333	2115751	1609799
ERR3200852	903	819	84	24	484440	9.750000	0.285714	2121769	1705112
ERR3200853	12	8	4	1	528973	2.000000	0.250000	2109856	1600999
ERR3200854	895	534	361	20	507495	1.479224	0.055402	2197635	1699100
ERR3200855	120	115	5	5	541128	23.000000	1.000000	2109609	1591961
ERR3200856	72	21	51	2	415892	0.411765	0.039216	2153391	1742613
ERR3200857	1	0	1	0	494207	0.000000	0.000000	2198618	1711114
ERR3200858	721	631	90	17	508280	7.011111	0.188889	2115111	1649975
ERR3200859	6	0	6	0	459322	0.000000	0.000000	2088821	1649380
ERR3200815	0	0	0	0	352555	0.000000	0.000000	2092976	1753524
ERR3200816	734	645	89	16	480826	7.247191	0.179775	2116202	1692484
ERR3200817	2	0	2	0	476496	0.000000	0.000000	2118764	1655968
ERR3200818	2695	1155	1540	25	341910	0.750000	0.016234	2096275	1787868
ERR3200819	0	0	0	0	521624	0.000000	0.000000	2113105	1605811
ERR3201021	0	0	0	0	412899	0.000000	0.000000	2143858	1742635
ERR3201022	2	0	2	0	537127	0.000000	0.000000	2126615	1601976
ERR3201023	11	0	11	0	501090	0.000000	0.000000	2176634	1684598
ERR3201024	0	0	0	0	511130	0.000000	0.000000	2130154	1631040
ERR3201025	1	0	1	0	519432	0.000000	0.000000	2108106	1608094
ERR3201026	4	0	4	0	412899	0.000000	0.000000	2140961	1739998
ERR3201027	106	80	26	4	578696	3.076923	0.153846	2177324	1614283
ERR3201028	0	0	0	0	510539	0.000000	0.000000	2111581	1618183
ERR3201029	127	117	10	2	521877	11.700000	0.200000	2113118	1610695
ERR3201030	10	0	10	0	536845	0.000000	0.000000	2143053	1618425
ERR3201031	0	0	0	0	490212	0.000000	0.000000	2074039	1599506
ERR3201032	132	88	44	6	520222	2.000000	0.136364	2107368	1611313
ERR3201033	0	0	0	0	528692	0.000000	0.000000	2183264	1662084
ERR3201034	2216	1649	567	40	592530	2.908289	0.070547	2085863	1625535
ERR3201035	0	0	0	0	528692	0.000000	0.000000	2184498	1663553
ERR3201036	0	0	0	0	527118	0.000000	0.000000	2115911	1605775
ERR3201037	228	181	47	9	492902	3.851064	0.191489	2170255	1693294
ERR3201038	0	0	0	0	429532	0.000000	0.000000	2141639	1723602
ERR3201039	48	25	23	2	443186	1.086957	0.086957	2146654	1712929
ERR3201040	0	0	0	0	619407	0.000000	0.000000	2129296	1539026
ERR3201041	19	8	11	1	533775	0.727273	0.090909	2111296	1599682
ERR3201042	2	0	2	0	557391	0.000000	0.000000	2178951	1632040
ERR3201043	10	6	4	1	441809	1.500000	0.250000	2149436	1719301
ERR3201044	8	0	8	0	518171	0.000000	0.000000	2105110	1602886
ERR3201045	0	0	0	0	522232	0.000000	0.000000	2112638	1609506
ERR3201046	319	263	56	10	521859	4.696429	0.178571	2102908	1620474
ERR3201047	18	18	0	2	415941	0.000000	0.000000	2150987	1740910
ERR3201048	8	0	8	0	533550	0.000000	0.000000	2106323	1591831
ERR3201049	393	355	38	7	518133	9.342105	0.184211	2105910	1615801
ERR3201050	0	0	0	0	490390	0.000000	0.000000	2143036	1663760
ERR3201051	1709	1139	570	28	519173	1.998246	0.049123	2106963	1685412
ERR3201052	3177	1798	1379	34	438641	1.303843	0.024656	2167547	1799790
ERR3201053	0	0	0	0	501090	0.000000	0.000000	2179076	1687452
ERR3201054	5	0	5	0	502058	0.000000	0.000000	2107217	1624653
ERR3201055	65	49	16	3	421204	3.062500	0.187500	2148645	1733640
ERR3201056	3	0	3	0	520938	0.000000	0.000000	2179711	1667666
ERR3201057	14	0	14	0	538832	0.000000	0.000000	2111368	1592537
ERR3201058	0	0	0	0	384000	0.000000	0.000000	2147985	1771487
ERR3201059	7	0	7	0	556399	0.000000	0.000000	2146860	1603632
ERR3201060	0	0	0	0	511312	0.000000	0.000000	2113355	1616871
ERR3201061	0	0	0	0	519432	0.000000	0.000000	2107495	1607021
ERR3201062	296	262	34	10	391772	7.705883	0.294118	2147999	1773233
ERR3201063	56	39	17	2	464864	2.294118	0.117647	2089195	1647776
ERR3201064	0	0	0	0	389437	0.000000	0.000000	2144184	1769150
ERR3201065	2	0	2	0	419475	0.000000	0.000000	2130792	1722250
ERR3201066	13	7	6	1	509215	1.166667	0.166667	2129553	1637677
ERR3201067	155	126	29	7	586891	4.344828	0.241379	2096588	1539812
ERR3201068	0	0	0	0	379681	0.000000	0.000000	2134646	1761870
ERR3201069	1731	1410	321	31	565898	4.392523	0.096573	2180260	1709847
ERR3201070	202	161	41	9	513706	3.926829	0.219512	2108075	1617817
ERR3201071	0	0	0	0	510539	0.000000	0.000000	2112566	1618138
ERR3201072	243	200	43	8	656018	4.651163	0.186047	2131912	1532524
ERR3201073	147	118	29	6	542687	4.068965	0.206897	2113899	1600207
ERR3201074	55	30	25	4	558738	1.200000	0.160000	2148829	1605385
ERR3201075	8	0	8	0	577304	0.000000	0.000000	2134629	1581505
ERR3201076	0	0	0	0	446174	0.000000	0.000000	2146890	1709584
ERR3201077	786	669	117	22	554321	5.717949	0.188034	2111208	1608734
ERR3201078	2234	1588	646	43	457822	2.458204	0.066563	2141720	1802116
ERR3201079	2	0	2	0	532783	0.000000	0.000000	2105530	1594851
ERR3201080	4	0	4	0	476496	0.000000	0.000000	2111044	1649481
ERR3201081	933	838	95	14	475694	8.821053	0.147368	2112467	1686612
ERR3201082	2	0	2	0	507610	0.000000	0.000000	2105656	1612953
ERR3201083	2	0	2	0	560915	0.000000	0.000000	2103296	1564990
ERR3201084	0	0	0	0	494207	0.000000	0.000000	2196304	1709232
ERR3201085	0	0	0	0	494207	0.000000	0.000000	2193292	1706042
ERR3201086	0	0	0	0	538880	0.000000	0.000000	2108446	1587729
ERR3201087	195	178	17	4	448721	10.470589	0.235294	2146914	1716106
ERR3201088	14	9	5	1	537131	1.800000	0.200000	2131361	1607351
ERR3201089	8	5	3	1	451530	1.666667	0.333333	2151525	1707902
ERR3201090	0	0	0	0	532783	0.000000	0.000000	2108808	1596836
ERR3201091	0	0	0	0	420594	0.000000	0.000000	2154561	1739558
ERR3201092	101	100	1	3	516348	100.000000	3.000000	2138477	1636808
ERR3201093	188	111	77	9	458581	1.441558	0.116883	2091616	1653805
ERR3201094	599	545	54	18	457239	10.092592	0.333333	2090929	1667537
ERR3201095	218	140	78	3	518171	1.794872	0.038462	2107252	1604253
ERR3201096	1029	828	201	14	551863	4.119403	0.069652	2181518	1686491
ERR3201097	6	0	6	0	521668	0.000000	0.000000	2115026	1610012
ERR3201098	313	258	55	13	455043	4.690909	0.236364	2152356	1755366
ERR3201099	0	0	0	0	538170	0.000000	0.000000	2110529	1590640
ERR3201100	311	285	26	4	546773	10.961538	0.153846	2111783	1593846
ERR3201101	10	7	3	1	544468	2.333333	0.333333	2116053	1590182
ERR3201102	128	120	8	4	390001	15.000000	0.500000	2149024	1772362
ERR3201103	5	0	5	0	528302	0.000000	0.000000	2116169	1608156
ERR3201104	9	0	9	0	518770	0.000000	0.000000	2109080	1609132
ERR3201105	5	0	5	0	619407	0.000000	0.000000	2131756	1538510
ERR3201106	11	0	11	0	429326	0.000000	0.000000	2131279	1714036
ERR3201107	0	0	0	0	501959	0.000000	0.000000	2175261	1682710
ERR3201108	0	0	0	0	486666	0.000000	0.000000	2112576	1645822
ERR3201109	0	0	0	0	506742	0.000000	0.000000	2163968	1670793
ERR3201110	0	0	0	0	501541	0.000000	0.000000	2183861	1691227
ERR3201111	218	181	37	5	515012	4.891892	0.135135	2109104	1614624
ERR3201112	0	0	0	0	517131	0.000000	0.000000	2111917	1613792
ERR3201113	0	0	0	0	557917	0.000000	0.000000	2182007	1633938
ERR3201114	0	0	0	0	377243	0.000000	0.000000	2118633	1755649
ERR3201115	1	0	1	0	488024	0.000000	0.000000	2195046	1712982
ERR3201116	679	611	68	18	529355	8.985294	0.264706	2103948	1622876
ERR3201117	0	0	0	0	431141	0.000000	0.000000	2142999	1721747
ERR3201118	0	0	0	0	458121	0.000000	0.000000	2139007	1697390
ERR3201119	2	0	2	0	519448	0.000000	0.000000	2109556	1607804
ERR3201120	18	0	18	0	533328	0.000000	0.000000	2104735	1591222
ERR3201121	393	344	49	6	390420	7.020408	0.122449	2122586	1759027
ERR3201122	4	0	4	0	518171	0.000000	0.000000	2110577	1607698
ERR3201123	2	0	2	0	417663	0.000000	0.000000	2148517	1740093
ERR3201124	56	48	8	3	421204	6.000000	0.375000	2152581	1741870
ERR3201125	0	0	0	0	521570	0.000000	0.000000	2108493	1606586
ERR3201126	574	513	61	15	552002	8.409836	0.245902	2113748	1595987
ERR3201127	9	0	9	0	557098	0.000000	0.000000	2116961	1579551
ERR3201128	0	0	0	0	534846	0.000000	0.000000	2112157	1595808
ERR3201129	0	0	0	0	471861	0.000000	0.000000	2137308	1676256
ERR3201130	78	43	35	3	535472	1.228571	0.085714	2116181	1601449
ERR3201131	34	26	8	2	526818	3.250000	0.250000	2133561	1626526
ERR3201132	8	8	0	1	540857	0.000000	0.000000	2119084	1597369
ERR3201133	4	0	4	0	519541	0.000000	0.000000	2113149	1613043
ERR3201134	1	0	1	0	448406	0.000000	0.000000	2155433	1716402
ERR3201135	3	0	3	0	518171	0.000000	0.000000	2111305	1608073
ERR3201136	0	0	0	0	519448	0.000000	0.000000	2108968	1607157
ERR3201137	464	371	93	21	485052	3.989247	0.225806	2156825	1707526
ERR3201138	12	0	12	0	389437	0.000000	0.000000	2147599	1772760
ERR3201139	0	0	0	0	528996	0.000000	0.000000	2108349	1597451
ERR3201140	0	0	0	0	510539	0.000000	0.000000	2115448	1620029
ERR3201141	5	0	5	0	519545	0.000000	0.000000	2113089	1615539
ERR3201142	310	283	27	13	552599	10.481482	0.481481	2129779	1624682
ERR3201143	0	0	0	0	578573	0.000000	0.000000	2115618	1558040
ERR3201144	0	0	0	0	483240	0.000000	0.000000	2115175	1646625
ERR3201145	49	29	20	2	537489	1.450000	0.100000	2111227	1593363
ERR3201146	0	0	0	0	451763	0.000000	0.000000	2154176	1710254
ERR3201147	0	0	0	0	525813	0.000000	0.000000	2131133	1622967
ERR3201148	243	168	75	11	545999	2.240000	0.146667	2117902	1592647
ERR3201149	0	0	0	0	518171	0.000000	0.000000	2104548	1602188
ERR3201150	1130	790	340	23	522081	2.323529	0.067647	2149073	1671610
ERR3201151	0	0	0	0	446982	0.000000	0.000000	2122363	1693527
ERR3201152	106	93	13	5	536643	7.153846	0.384615	2111523	1599375
ERR3201153	27	16	11	1	518172	1.454545	0.090909	2097664	1597143
ERR3201154	56	13	43	2	455143	0.302326	0.046512	2079318	1638255
ERR3201155	3	0	3	0	416946	0.000000	0.000000	2145816	1739768
ERR3201156	40	10	30	2	501090	0.333333	0.066667	2182068	1689783
ERR3201157	0	0	0	0	488024	0.000000	0.000000	2198992	1717000
ERR3201158	0	0	0	0	532808	0.000000	0.000000	2104971	1594374
ERR3201159	11	0	11	0	415941	0.000000	0.000000	2148952	1738657
ERR3201160	1	0	1	0	487816	0.000000	0.000000	2198914	1716947
ERR3201161	12	0	12	0	506089	0.000000	0.000000	2139446	1653584
ERR3201162	0	0	0	0	429326	0.000000	0.000000	2130718	1713966
ERR3201163	902	773	129	21	566398	5.992248	0.162791	2107894	1576361
ERR3201164	0	0	0	0	528692	0.000000	0.000000	2186764	1665271
ERR3201165	15	5	10	1	510539	0.500000	0.100000	2113169	1617484
ERR3201166	378	325	53	15	518140	6.132075	0.283019	2171287	1677091
ERR3201167	1	0	1	0	502058	0.000000	0.000000	2112941	1629597
ERR3201168	8	0	8	0	619407	0.000000	0.000000	2131617	1538864
ERR3201169	240	201	39	11	553984	5.153846	0.282051	2146087	1606303
ERR3201170	0	0	0	0	476496	0.000000	0.000000	2109259	1647715
ERR3201171	773	755	18	7	583025	41.944443	0.388889	2110769	1560264
ERR3201172	64	50	14	3	393705	3.571429	0.214286	2147837	1772826
ERR3201173	0	0	0	0	518879	0.000000	0.000000	2115056	1614984
ERR3201174	4	0	4	0	451117	0.000000	0.000000	2148938	1706328
ERR3201175	0	0	0	0	442802	0.000000	0.000000	2090608	1668126
ERR3201176	32	21	11	3	558183	1.909091	0.272727	2111661	1571944
ERR3201177	6	0	6	0	488024	0.000000	0.000000	2195761	1713730
ERR3201178	0	0	0	0	428586	0.000000	0.000000	2149038	1730447
ERR3201179	0	0	0	0	543230	0.000000	0.000000	2132567	1609562
ERR3201180	0	0	0	0	393049	0.000000	0.000000	2145003	1766973
ERR3201181	256	174	82	9	453081	2.121951	0.109756	2085484	1652383
ERR3201182	0	0	0	0	499598	0.000000	0.000000	2191051	1696385
ERR3201183	57	33	24	4	492561	1.375000	0.166667	2138188	1669268
ERR3201283	0	0	0	0	477588	0.000000	0.000000	2119169	1654534
ERR3201284	119	93	26	5	443543	3.576923	0.192308	2155972	1724166
ERR3201285	0	0	0	0	538009	0.000000	0.000000	2116559	1594683
ERR3201286	0	0	0	0	449036	0.000000	0.000000	2156474	1716432
ERR3201287	509	386	123	14	411541	3.138211	0.113821	2064984	1673716
ERR3201288	8	0	8	0	419475	0.000000	0.000000	2134456	1726776
ERR3201289	0	0	0	0	413739	0.000000	0.000000	2156127	1748233
ERR3201290	407	283	124	11	586064	2.282258	0.088710	2102069	1558694
ERR3201291	1190	947	243	23	550777	3.897119	0.094650	2133277	1649850
ERR3201292	0	0	0	0	529379	0.000000	0.000000	2119496	1607933
ERR3201193	184	170	14	9	464268	12.142858	0.642857	2158500	1718031
ERR3201293	142	120	22	7	496386	5.454545	0.318182	2124782	1643926
ERR3201294	0	0	0	0	557391	0.000000	0.000000	2183070	1635675
ERR3201295	275	262	13	6	492955	20.153847	0.461538	2139093	1679427
ERR3201296	1253	1163	90	26	572944	12.922222	0.288889	2118863	1609099
ERR3201297	0	0	0	0	442898	0.000000	0.000000	2156094	1721356
ERR3201298	4	0	4	0	619407	0.000000	0.000000	2137896	1544639
ERR3201299	8	7	1	1	521877	7.000000	1.000000	2116255	1612866
ERR3201300	0	0	0	0	518461	0.000000	0.000000	2114454	1612564
ERR3201301	0	0	0	0	532609	0.000000	0.000000	2153246	1626920
ERR3201302	2	0	2	0	521570	0.000000	0.000000	2119010	1613993
ERR3201194	0	0	0	0	389437	0.000000	0.000000	2157201	1777192
ERR3201303	539	229	310	4	346438	0.738710	0.012903	2129980	1803082
ERR3201304	340	282	58	14	472545	4.862069	0.241379	2151356	1708875
ERR3201305	10	0	10	0	371423	0.000000	0.000000	2146949	1787972
ERR3201306	0	0	0	0	484481	0.000000	0.000000	2145541	1676377
ERR3201307	0	0	0	0	451530	0.000000	0.000000	2157006	1713245
ERR3201308	576	434	142	20	580557	3.056338	0.140845	2153724	1628536
ERR3201309	0	0	0	0	497326	0.000000	0.000000	2143696	1662132
ERR3201310	14	0	14	0	415941	0.000000	0.000000	2156024	1746047
ERR3201311	6	0	6	0	492411	0.000000	0.000000	2142231	1673950
ERR3201312	0	0	0	0	492649	0.000000	0.000000	2138003	1670895
ERR3201195	11	0	11	0	486108	0.000000	0.000000	2148720	1676080
ERR3201313	13	0	13	0	422482	0.000000	0.000000	2139482	1726940
ERR3201314	1	0	1	0	473060	0.000000	0.000000	2137669	1674482
ERR3201315	1	0	1	0	473060	0.000000	0.000000	2141799	1677020
ERR3201316	0	0	0	0	360798	0.000000	0.000000	2132685	1788849
ERR3201317	27	14	13	2	468669	1.076923	0.153846	2144001	1681732
ERR3201318	227	37	190	4	431357	0.194737	0.021053	2138694	1723412
ERR3201319	67	60	7	1	537863	8.571428	0.142857	2119526	1597505
ERR3201320	66	18	48	2	548501	0.375000	0.041667	2115265	1586019
ERR3201321	601	583	18	8	492932	32.388889	0.444444	2191957	1713507
ERR3201322	0	0	0	0	398790	0.000000	0.000000	2136978	1748940
ERR3201196	7	0	7	0	623019	0.000000	0.000000	2140127	1540070
ERR3201323	0	0	0	0	556476	0.000000	0.000000	2115179	1575976
ERR3201324	0	0	0	0	507610	0.000000	0.000000	2107498	1613991
ERR3201325	0	0	0	0	525374	0.000000	0.000000	2119699	1611540
ERR3201326	1	0	1	0	525813	0.000000	0.000000	2136241	1628962
ERR3201327	0	0	0	0	525012	0.000000	0.000000	2104116	1602057
ERR3201328	0	0	0	0	538980	0.000000	0.000000	2117619	1597172
ERR3201329	208	179	29	8	448811	6.172414	0.275862	2154359	1726342
ERR3201330	19	0	19	0	484416	0.000000	0.000000	2146931	1678305
ERR3201331	0	0	0	0	462125	0.000000	0.000000	2097265	1654351
ERR3201332	0	0	0	0	521570	0.000000	0.000000	2116081	1611669
ERR3201197	125	119	6	3	626880	19.833334	0.500000	2140812	1539893
ERR3201333	1	0	1	0	558770	0.000000	0.000000	2118337	1578685
ERR3201334	0	0	0	0	536083	0.000000	0.000000	2113909	1592129
ERR3201335	427	413	14	7	459776	29.500000	0.500000	2158526	1717870
ERR3201336	0	0	0	0	518463	0.000000	0.000000	2106733	1605218
ERR3201337	1190	1105	85	29	542308	13.000000	0.341176	2118055	1640109
ERR3201338	77	55	22	3	426163	2.500000	0.136364	2156630	1744249
ERR3201339	48	28	20	2	416946	1.400000	0.100000	2151853	1745708
ERR3201340	0	0	0	0	520938	0.000000	0.000000	2186063	1674011
ERR3201341	0	0	0	0	524145	0.000000	0.000000	2186346	1671975
ERR3201342	0	0	0	0	627290	0.000000	0.000000	2142363	1536194
ERR3201198	0	0	0	0	508174	0.000000	0.000000	2188871	1689222
ERR3201343	0	0	0	0	557801	0.000000	0.000000	2116181	1575750
ERR3201344	117	100	17	3	486721	5.882353	0.176471	2180342	1708826
ERR3201345	0	0	0	0	524145	0.000000	0.000000	2185671	1671699
ERR3201346	5	5	0	1	497323	0.000000	0.000000	2143125	1661905
ERR3201347	0	0	0	0	549288	0.000000	0.000000	2114483	1585542
ERR3201348	139	88	51	7	558540	1.725490	0.137255	2153972	1610032
ERR3201349	4	0	4	0	478475	0.000000	0.000000	2155623	1684575
ERR3201350	27	21	6	3	488024	3.500000	0.500000	2197922	1715494
ERR3201351	26	15	11	2	538384	1.363636	0.181818	2113048	1591040
ERR3201352	1	0	1	0	486893	0.000000	0.000000	2155264	1675881
ERR3201199	0	0	0	0	483240	0.000000	0.000000	2119106	1649462
ERR3201353	1	0	1	0	524145	0.000000	0.000000	2186142	1672289
ERR3201354	418	377	41	16	473314	9.195122	0.390244	2157115	1716380
ERR3201355	0	0	0	0	497590	0.000000	0.000000	2114226	1628527
ERR3201356	92	81	11	3	548871	7.363636	0.272727	2111205	1583332
ERR3201357	0	0	0	0	537127	0.000000	0.000000	2130951	1606194
ERR3201358	511	486	25	13	508642	19.440001	0.520000	2193196	1697474
ERR3201359	3	0	3	0	501541	0.000000	0.000000	2183129	1690410
ERR3201360	9	0	9	0	431141	0.000000	0.000000	2147305	1725390
ERR3201361	190	140	50	10	533124	2.800000	0.200000	2112308	1614590
ERR3201362	0	0	0	0	502548	0.000000	0.000000	2148925	1667020
ERR3201200	0	0	0	0	580749	0.000000	0.000000	2139543	1581923
ERR3201363	201	61	140	4	434304	0.435714	0.028571	2140760	1725623
ERR3201364	126	64	62	5	485925	1.032258	0.080645	2136298	1661704
ERR3201365	30	15	15	2	487816	1.000000	0.133333	2198834	1717243
ERR3201366	0	0	0	0	533869	0.000000	0.000000	2107741	1593316
ERR3201367	134	100	34	6	525804	2.941176	0.176471	2133886	1628411
ERR3201369	0	0	0	0	486108	0.000000	0.000000	2146361	1673643
ERR3201370	0	0	0	0	574702	0.000000	0.000000	2181286	1617762
ERR3201371	76	37	39	2	492411	0.948718	0.051282	2134570	1668012
ERR3201372	696	616	80	18	531479	7.700000	0.225000	2179950	1691365
ERR3201201	0	0	0	0	456916	0.000000	0.000000	2122731	1680846
ERR3201373	3	0	3	0	510539	0.000000	0.000000	2119338	1622770
ERR3201374	5	0	5	0	510889	0.000000	0.000000	2109777	1618176
ERR3201202	0	0	0	0	575811	0.000000	0.000000	2115919	1565433
ERR3201184	0	0	0	0	506089	0.000000	0.000000	2148044	1661036
ERR3201203	79	65	14	3	535184	4.642857	0.214286	2118842	1602008
ERR3201204	0	0	0	0	459467	0.000000	0.000000	2158965	1707255
ERR3201205	0	0	0	0	485831	0.000000	0.000000	2128265	1647240
ERR3201206	0	0	0	0	417663	0.000000	0.000000	2154426	1745007
ERR3201207	0	0	0	0	428157	0.000000	0.000000	2142173	1723809
ERR3201208	101	75	26	4	519125	2.884615	0.153846	2112451	1611455
ERR3201209	2	0	2	0	566782	0.000000	0.000000	2123094	1574672
ERR3201210	0	0	0	0	566779	0.000000	0.000000	2121243	1573219
ERR3201211	31	10	21	2	537844	0.476190	0.095238	2117358	1597269
ERR3201212	8	7	1	1	519236	7.000000	1.000000	2122791	1619999
ERR3201185	0	0	0	0	537864	0.000000	0.000000	2119684	1598989
ERR3201213	0	0	0	0	522334	0.000000	0.000000	2119694	1614752
ERR3201214	165	124	41	8	450644	3.024390	0.195122	2156028	1724744
ERR3201215	13	0	13	0	499598	0.000000	0.000000	2184322	1689074
ERR3201216	0	0	0	0	394072	0.000000	0.000000	2171593	1785923
ERR3201217	329	325	4	7	530867	81.250000	1.750000	2113626	1606678
ERR3201218	0	0	0	0	459322	0.000000	0.000000	2089211	1650220
ERR3201219	1197	926	271	29	529175	3.416974	0.107011	2145518	1653033
ERR3201220	38	27	11	2	442872	2.454545	0.181818	2157795	1722620
ERR3201221	63	39	24	5	545392	1.625000	0.208333	2119057	1592773
ERR3201222	0	0	0	0	508174	0.000000	0.000000	2187914	1688262
ERR3201186	7	0	7	0	524037	0.000000	0.000000	2137062	1629649
ERR3201223	18	0	18	0	455119	0.000000	0.000000	2089548	1647333
ERR3201224	7	7	0	1	446982	0.000000	0.000000	2124633	1695839
ERR3201225	6	0	6	0	532734	0.000000	0.000000	2115953	1602234
ERR3201226	0	0	0	0	429058	0.000000	0.000000	2091957	1680350
ERR3201227	387	338	49	14	408502	6.897959	0.285714	2137895	1767849
ERR3201228	60	33	27	1	517486	1.222222	0.037037	2123281	1622966
ERR3201229	0	0	0	0	520938	0.000000	0.000000	2184901	1672639
ERR3201230	244	203	41	5	536329	4.951220	0.121951	2123917	1608664
ERR3201231	0	0	0	0	472793	0.000000	0.000000	2148092	1692353
ERR3201232	0	0	0	0	561270	0.000000	0.000000	2113119	1572349
ERR3201187	4	0	4	0	413739	0.000000	0.000000	2156832	1748464
ERR3201233	0	0	0	0	580749	0.000000	0.000000	2140436	1582116
ERR3201234	0	0	0	0	416946	0.000000	0.000000	2153033	1745352
ERR3201235	830	704	126	24	648158	5.587302	0.190476	2139417	1543319
ERR3201236	107	60	47	6	451087	1.276596	0.127660	2129417	1702058
ERR3201237	0	0	0	0	626880	0.000000	0.000000	2143591	1542632
ERR3201238	0	0	0	0	619407	0.000000	0.000000	2140764	1547208
ERR3201239	0	0	0	0	437859	0.000000	0.000000	2091221	1669756
ERR3201240	1	0	1	0	437859	0.000000	0.000000	2087466	1666084
ERR3201241	0	0	0	0	453645	0.000000	0.000000	2157513	1711428
ERR3201242	3216	1390	1826	33	288037	0.761227	0.018072	2160002	1945917
ERR3201188	0	0	0	0	417302	0.000000	0.000000	2158164	1748946
ERR3201243	41	21	20	2	484444	1.050000	0.100000	2147600	1677774
ERR3201244	20	0	20	0	455119	0.000000	0.000000	2088614	1647009
ERR3201245	19	16	3	1	627291	5.333333	0.333333	2147068	1540595
ERR3201246	0	0	0	0	519656	0.000000	0.000000	2169329	1661419
ERR3201247	63	31	32	3	445856	0.968750	0.093750	2152846	1716921
ERR3201248	280	222	58	9	489610	3.827586	0.155172	2183789	1706175
ERR3201249	0	0	0	0	412899	0.000000	0.000000	2145652	1747509
ERR3201250	631	603	28	15	569226	21.535715	0.535714	2120622	1580171
ERR3201251	83	70	13	2	519234	5.384615	0.153846	2119681	1619774
ERR3201252	97	67	30	5	539116	2.233333	0.166667	2143980	1630042
ERR3201189	7	0	7	0	431141	0.000000	0.000000	2150433	1728169
ERR3201253	0	0	0	0	540853	0.000000	0.000000	2123939	1600034
ERR3201254	124	121	3	3	449796	40.333332	1.000000	2159379	1718636
ERR3201255	0	0	0	0	520938	0.000000	0.000000	2187382	1674990
ERR3201257	1	0	1	0	412899	0.000000	0.000000	2152721	1749605
ERR3201258	1	0	1	0	579233	0.000000	0.000000	2122777	1563359
ERR3201259	4	0	4	0	521568	0.000000	0.000000	2119474	1615266
ERR3201260	1448	1295	153	36	507707	8.464052	0.235294	2120574	1685288
ERR3201261	0	0	0	0	487816	0.000000	0.000000	2202549	1719872
ERR3201262	0	0	0	0	417663	0.000000	0.000000	2156692	1747411
ERR3201190	0	0	0	0	511558	0.000000	0.000000	2117549	1624510
ERR3201263	0	0	0	0	508174	0.000000	0.000000	2183116	1682788
ERR3201264	61	50	11	5	538855	4.545455	0.454545	2115340	1601725
ERR3201265	12	0	12	0	510539	0.000000	0.000000	2119927	1623212
ERR3201266	0	0	0	0	497315	0.000000	0.000000	2145978	1663059
ERR3201267	4	0	4	0	577304	0.000000	0.000000	2146652	1590386
ERR3201268	0	0	0	0	512220	0.000000	0.000000	2116377	1618118
ERR3201269	0	0	0	0	451667	0.000000	0.000000	2127927	1691510
ERR3201270	0	0	0	0	492411	0.000000	0.000000	2144869	1676002
ERR3201271	65	27	38	3	403480	0.710526	0.078947	2152659	1757816
ERR3201272	2	0	2	0	573336	0.000000	0.000000	2117935	1564603
ERR3201191	0	0	0	0	531382	0.000000	0.000000	2153483	1632754
ERR3201273	0	0	0	0	476308	0.000000	0.000000	2200956	1730023
ERR3201274	2	0	2	0	573336	0.000000	0.000000	2115596	1562622
ERR3201275	19	5	14	1	509177	0.357143	0.071429	2143753	1659180
ERR3201276	206	172	34	6	511774	5.058824	0.176471	2117891	1619898
ERR3201277	31	27	4	1	537127	6.750000	0.250000	2137049	1611275
ERR3201279	9	5	4	1	538383	1.250000	0.250000	2115335	1592771
ERR3201280	57	16	41	2	468685	0.390244	0.048780	2117397	1659869
ERR3201281	0	0	0	0	533532	0.000000	0.000000	2110187	1597970
ERR3201282	722	629	93	17	438830	6.763441	0.182796	2110150	1688743
ERR3201192	141	130	11	3	625493	11.818182	0.272727	2143184	1548635
123	87	36	6	384000	2.416667	0.166667	2156396	1783248
244	187	57	10	379681	3.280702	0.175439	2160969	1802934
1156	764	392	26	363280	1.948980	0.066327	2166200	1850580
25	10	15	1	416946	0.666667	0.066667	2156160	1749353
12	7	5	1	416946	1.400000	0.200000	2160678	1752037
248	224	24	15	416946	9.333333	0.625000	2162698	1766730
915	611	304	24	403480	2.009868	0.078947	2165413	1794002
1675	1040	635	29	378554	1.637795	0.045669	2174347	1858684
2171	812	1359	22	320028	0.597498	0.016188	2184185	1935358
4199	2030	2169	41	251982	0.935915	0.018903	2204099	2068109
46	29	17	2	431298	1.705882	0.117647	2152224	1740094
1880	1421	459	32	421570	3.095860	0.069717	2161924	1829134
1083	968	115	18	384083	8.417392	0.156522	2154239	1817578
19	6	13	1	393049	0.461538	0.076923	2154395	1779087
28	9	19	2	388942	0.473684	0.105263	2157880	1781334
22	16	6	3	389437	2.666667	0.500000	2157653	1780550
18	9	9	1	389437	1.000000	0.111111	2154695	1776792
6	0	6	0	389437	0.000000	0.000000	2161789	1781420
15	10	5	2	389437	2.000000	0.400000	2165090	1784649
8	4	4	1	389437	1.000000	0.250000	2171464	1790915
125	104	21	9	389437	4.952381	0.428571	2172297	1792160
633	539	94	16	388942	5.734043	0.170213	2173777	1828388
12	0	12	0	441809	0.000000	0.000000	2151224	1719500
12	0	12	0	441809	0.000000	0.000000	2160959	1728698
21	9	12	1	445750	0.750000	0.083333	2148908	1716670
0	0	0	0	441809	0.000000	0.000000	2163811	1730947
15	10	5	1	441809	2.000000	0.200000	2165621	1732731
35	30	5	3	441809	6.000000	0.600000	2172636	1739003
50	31	19	3	441809	1.631579	0.157895	2175133	1741479
21	7	14	1	441809	0.500000	0.071429	2180737	1751492
989	785	204	31	437218	3.848039	0.151961	2182116	1778724
1	0	1	0	423181	0.000000	0.000000	2159385	1745275
717	534	183	26	423181	2.918033	0.142077	2162118	1761683
1110	858	252	30	408596	3.404762	0.119048	2190366	1830480
318	235	83	11	409326	2.831325	0.132530	2161328	1768796
261	178	83	8	409886	2.144578	0.096386	2147561	1757641
611	438	173	19	402447	2.531792	0.109827	2170613	1795498
366	266	100	15	380404	2.660000	0.150000	2174189	1814153
354	279	75	15	363784	3.720000	0.200000	2195602	1847923
143	108	35	10	349728	3.085714	0.285714	2196956	1853966
183	111	72	7	344680	1.541667	0.097222	2199665	1861390
331	211	120	12	339965	1.758333	0.100000	2201345	1873237
3986	2051	1935	37	329761	1.059948	0.019121	2203015	1980328
1149	841	308	25	399759	2.730520	0.081169	2105085	1745106
2698	1281	1417	25	364412	0.904023	0.017643	2116903	1805964
2776	1376	1400	30	314732	0.982857	0.021429	2132728	1872765
1391	1039	352	32	443021	2.951705	0.090909	2103962	1734654
17	13	4	1	437859	3.250000	0.250000	2095016	1673222
53	19	34	3	437859	0.558824	0.088235	2102827	1680809
447	336	111	16	437859	3.027027	0.144144	2104816	1697125
1	0	1	0	429058	0.000000	0.000000	2090103	1677959
3	0	3	0	429058	0.000000	0.000000	2088409	1677056
7	0	7	0	429058	0.000000	0.000000	2097358	1685667
3	0	3	0	429058	0.000000	0.000000	2101225	1689125
51	22	29	3	429058	0.758621	0.103448	2102847	1689913
8	0	8	0	442246	0.000000	0.000000	2095092	1670411
2	0	2	0	442246	0.000000	0.000000	2097891	1672962
55	47	8	3	442246	5.875000	0.375000	2100670	1675722
315	271	44	12	442246	6.159091	0.272727	2106515	1693564
285	190	95	10	452249	2.000000	0.105263	2155546	1734980
2	0	2	0	431141	0.000000	0.000000	2151178	1728881
1	0	1	0	431141	0.000000	0.000000	2155331	1732359
46	38	8	4	431141	4.750000	0.500000	2159270	1737949
41	18	23	1	429125	0.782609	0.043478	2164939	1743601
150	126	24	2	429125	5.250000	0.083333	2166917	1745492
90	59	31	5	429058	1.903226	0.161290	2173896	1752113
330	277	53	16	429058	5.226415	0.301887	2175512	1759892
649	506	143	19	422815	3.538461	0.132867	2181308	1776552
201	176	25	3	442802	7.040000	0.120000	2101758	1678553
123	90	33	5	442747	2.727273	0.151515	2103629	1687423
770	620	150	17	483243	4.133333	0.113333	2167106	1723646
0	0	0	0	459322	0.000000	0.000000	2098491	1658739
191	137	54	9	459323	2.537037	0.166667	2103276	1670738
207	152	55	9	451861	2.763636	0.163636	2178496	1745448
122	96	26	9	441112	3.692308	0.346154	2179393	1751670
362	335	27	14	435615	12.407408	0.518519	2181634	1755008
0	0	0	0	462125	0.000000	0.000000	2101801	1657713
338	301	37	7	462125	8.135135	0.189189	2103585	1659067
674	546	128	16	487334	4.265625	0.125000	2100895	1658222
496	423	73	14	462126	5.794520	0.191781	2113101	1694156
455	303	152	17	457569	1.993421	0.111842	2099860	1680103
241	169	72	11	438580	2.347222	0.152778	2106132	1689932
114	98	16	9	434089	6.125000	0.562500	2108508	1691985
184	152	32	8	434090	4.750000	0.250000	2118433	1699337
176	153	23	10	434090	6.652174	0.434783	2191112	1762720
864	675	189	19	432103	3.571429	0.100529	2191911	1785179
1339	903	436	26	409829	2.071101	0.059633	2195815	1818857
3327	1627	1700	35	379892	0.957059	0.020588	2197269	1874674
508	426	82	12	448406	5.195122	0.146341	2160430	1782617
1172	934	238	13	428734	3.924370	0.054622	2175758	1788248
167	92	75	6	394072	1.226667	0.080000	2183189	1802068
2825	1453	1372	35	386807	1.059038	0.025510	2190396	1867434
2686	1166	1520	27	324590	0.767105	0.017763	2212200	1950687
1975	848	1127	19	261836	0.752440	0.016859	2214180	1980313
132	58	74	5	413739	0.783784	0.067568	2161606	1753135
2	0	2	0	413739	0.000000	0.000000	2150919	1743239
4	0	4	0	413739	0.000000	0.000000	2153222	1745448
63	26	37	2	413739	0.702703	0.054054	2155977	1747184
8	0	8	0	413739	0.000000	0.000000	2156382	1747949
21	11	10	1	413739	1.100000	0.100000	2162475	1753632
5	0	5	0	435395	0.000000	0.000000	2151816	1722118
117	101	16	2	435395	6.312500	0.125000	2159077	1750714
0	0	0	0	413739	0.000000	0.000000	2152885	1745205
11	5	6	1	413739	0.833333	0.166667	2161082	1752572
30	28	2	2	413739	14.000000	1.000000	2164247	1754756
25	18	7	1	413739	2.571429	0.142857	2168241	1758526
23	14	9	2	413739	1.555556	0.222222	2168728	1759002
33	23	10	3	413739	2.300000	0.300000	2171401	1761465
16	0	16	0	413739	0.000000	0.000000	2173294	1763118
26	8	18	1	413739	0.444444	0.055556	2173417	1763241
85	48	37	5	413739	1.297297	0.135135	2177261	1767347
5	0	5	0	415941	0.000000	0.000000	2155829	1745654
14	5	9	1	415941	0.555556	0.111111	2158882	1747923
18	8	10	1	420594	0.800000	0.100000	2159549	1743916
31	20	11	1	420594	1.818182	0.090909	2163443	1747041
46	40	6	2	420594	6.666667	0.333333	2166444	1754668
19	14	5	1	415941	2.800000	0.200000	2167314	1755337
13	8	5	1	415941	1.600000	0.200000	2172546	1760160
10	7	3	1	415941	2.333333	0.333333	2173945	1761558
91	35	56	4	415941	0.625000	0.071429	2175258	1763139
148	55	93	5	415670	0.591398	0.053763	2176130	1766072
1446	1022	424	35	413400	2.410377	0.082547	2179988	1824454
98	36	62	2	478475	0.580645	0.032258	2160868	1691158
1981	1315	666	44	475571	1.974474	0.066066	2164719	1722755
17	8	9	1	536845	0.888889	0.111111	2152564	1626742
62	56	6	4	536845	9.333333	0.666667	2160265	1637902
103	64	39	5	531382	1.641026	0.128205	2163405	1641024
4	0	4	0	556399	0.000000	0.000000	2154194	1610071
19	12	7	2	556399	1.714286	0.285714	2159493	1614767
6	5	1	1	556386	5.000000	1.000000	2150327	1606718
8	6	2	1	556386	3.000000	0.500000	2164780	1618819
10	0	10	0	556386	0.000000	0.000000	2167145	1620617
362	321	41	10	556386	7.829268	0.243902	2168746	1647069
230	181	49	11	531264	3.693877	0.224490	2170791	1648975
1139	885	254	23	531264	3.484252	0.090551	2176095	1684271
1187	754	433	26	547416	1.741339	0.060046	2152888	1627364
1109	618	491	22	532609	1.258656	0.044807	2163645	1637609
1345	909	436	30	531532	2.084862	0.068807	2175843	1681659
605	496	109	20	498968	4.550459	0.183486	2187896	1706120
2168	1430	738	43	485562	1.937669	0.058266	2190786	1747434
2514	1821	693	48	446779	2.627706	0.069264	2196335	1840050
1881	1198	683	36	356966	1.754026	0.052709	2204021	1902165
20	15	5	1	417663	3.000000	0.200000	2157994	1748519
3	0	3	0	417663	0.000000	0.000000	2159581	1750021
82	63	19	8	417663	3.315789	0.421053	2161077	1751457
9	0	9	0	417302	0.000000	0.000000	2161407	1752021
17	5	12	1	417302	0.416667	0.083333	2162226	1752651
144	112	32	6	417302	3.500000	0.187500	2164639	1759180
65	47	18	3	445940	2.611111	0.166667	2152617	1717796
355	325	30	10	445940	10.833333	0.333333	2160301	1741250
155	125	30	8	428586	4.166667	0.266667	2165090	1755170
874	798	76	14	481410	10.500000	0.184211	2155390	1717092
90	45	45	5	446174	1.000000	0.111111	2161915	1723187
172	115	57	8	449036	2.017544	0.140351	2164727	1723397
52	26	26	3	452366	1.000000	0.115385	2156858	1716532
71	46	25	5	448389	1.840000	0.200000	2161088	1720416
324	275	49	12	457607	5.612245	0.244898	2156699	1716082
15	5	10	1	448389	0.500000	0.100000	2163205	1722188
12	7	5	1	448389	1.400000	0.200000	2163557	1722097
3	0	3	0	448389	0.000000	0.000000	2166916	1725031
11	0	11	0	448389	0.000000	0.000000	2170252	1728352
8	0	8	0	448389	0.000000	0.000000	2172303	1730256
69	40	29	5	448389	1.379310	0.172414	2174912	1732491
35	14	21	2	448389	0.666667	0.095238	2176852	1734255
13	0	13	0	448389	0.000000	0.000000	2154761	1715489
137	116	21	4	451763	5.523809	0.190476	2160037	1719227
54	33	21	5	448389	1.571429	0.238095	2164263	1723223
35	8	27	1	448389	0.296296	0.037037	2177406	1734670
64	41	23	6	448389	1.782609	0.260870	2178917	1735875
79	46	33	5	448477	1.393939	0.151515	2158913	1718405
118	70	48	7	448389	1.458333	0.145833	2162683	1721672
141	88	53	7	448389	1.660377	0.132075	2180857	1739929
213	167	46	14	446159	3.630435	0.304348	2182215	1744534
0	0	0	0	453645	0.000000	0.000000	2154066	1709576
16	6	10	1	453645	0.600000	0.100000	2156036	1710630
5	0	5	0	453645	0.000000	0.000000	2157079	1711657
10	5	5	1	453645	1.000000	0.200000	2157813	1712362
17	7	10	1	453645	0.700000	0.100000	2163240	1717255
7	0	7	0	453645	0.000000	0.000000	2168224	1720851
44	25	19	3	459467	1.315789	0.157895	2165713	1715578
58	42	16	4	457279	2.625000	0.250000	2169645	1723018
495	456	39	10	453645	11.692307	0.256410	2172018	1735260
50	26	24	3	451530	1.083333	0.125000	2159449	1715635
57	37	20	4	451485	1.850000	0.200000	2153271	1710783
56	23	33	3	451485	0.696970	0.090909	2166670	1722852
38	27	11	3	451117	2.454545	0.272727	2167877	1723928
100	68	32	5	451066	2.125000	0.156250	2169749	1733944
75	37	38	4	442898	0.973684	0.105263	2170759	1734972
149	127	22	5	486893	5.772727	0.227273	2158600	1686907
3	0	3	0	478664	0.000000	0.000000	2152125	1682448
563	496	67	20	478664	7.402985	0.298507	2163516	1726810
277	237	40	9	449614	5.925000	0.225000	2167227	1729241
64	43	21	5	444975	2.047619	0.238095	2170774	1732777
78	56	22	8	444964	2.545455	0.363636	2172450	1735998
87	49	38	4	443170	1.289474	0.105263	2177620	1740173
104	61	43	7	443170	1.418605	0.162791	2177687	1740539
60	28	32	3	442872	0.875000	0.093750	2180687	1743489
77	59	18	4	442872	3.277778	0.222222	2182800	1744970
36	6	30	1	442872	0.200000	0.033333	2164997	1728768
141	105	36	10	442872	2.916667	0.277778	2183113	1745154
110	71	39	7	442872	1.820513	0.179487	2190486	1752018
224	189	35	8	463605	5.400000	0.228571	2150773	1713365
90	60	30	5	456819	2.000000	0.166667	2154763	1718522
332	306	26	15	455010	11.769231	0.576923	2167983	1729834
328	291	37	9	442846	7.864865	0.243243	2193452	1776888
157	104	53	5	418416	1.962264	0.094340	2193820	1782730
74	54	20	6	412875	2.700000	0.300000	2194295	1783739
3714	2289	1425	41	412199	1.606316	0.028772	2196195	1895160
2935	1559	1376	37	302379	1.132994	0.026890	2211681	1977967
1637	611	1026	21	234169	0.595517	0.020468	2219217	1996043
2315	893	1422	27	223281	0.627989	0.018987	2221094	2044910
11	6	5	1	330304	1.200000	0.200000	2105920	1786361
3	0	3	0	330304	0.000000	0.000000	2109989	1790006
3157	1630	1527	33	330304	1.067453	0.021611	2110799	1879835
19	5	14	1	507610	0.357143	0.071429	2112949	1618749
39	10	29	2	507610	0.344828	0.068966	2115573	1620841
11	5	6	1	518171	0.833333	0.166667	2118716	1613924
8	0	8	0	518171	0.000000	0.000000	2121062	1615980
100	70	30	8	518171	2.333333	0.266667	2131189	1625252
3	0	3	0	538383	0.000000	0.000000	2109269	1590004
4	0	4	0	538384	0.000000	0.000000	2118984	1595806
5	0	5	0	538384	0.000000	0.000000	2123618	1600319
130	103	27	7	538384	3.814815	0.259259	2125687	1621044
15	0	15	0	518171	0.000000	0.000000	2111304	1607924
9	7	2	1	518171	3.500000	0.500000	2111485	1607629
3	0	3	0	518171	0.000000	0.000000	2113335	1609342
6	0	6	0	518172	0.000000	0.000000	2117324	1613011
14	5	9	1	518172	0.555556	0.111111	2120357	1615396
26	14	12	1	518172	1.166667	0.083333	2124807	1619641
10	6	4	1	518172	1.500000	0.250000	2126414	1621187
17	5	12	1	518172	0.416667	0.083333	2127252	1621451
27	15	12	2	518172	1.250000	0.166667	2127600	1621791
19	5	14	1	518172	0.357143	0.071429	2131440	1625294
59	30	29	3	518171	1.034483	0.103448	2112287	1609202
34	18	16	2	518172	1.125000	0.125000	2131555	1625405
30	14	16	3	518172	0.875000	0.187500	2137717	1631138
94	42	52	5	518171	0.807692	0.096154	2118947	1615112
151	121	30	8	518172	4.033333	0.266667	2138297	1642301
303	255	48	15	507584	5.312500	0.312500	2140667	1651337
1	0	1	0	521625	0.000000	0.000000	2117051	1609224
347	298	49	13	521625	6.081633	0.265306	2119930	1625184
0	0	0	0	532808	0.000000	0.000000	2107380	1596762
15	5	10	1	532808	0.500000	0.100000	2116726	1603869
0	0	0	0	532808	0.000000	0.000000	2110303	1597717
38	21	17	2	532808	1.235294	0.117647	2111425	1598805
14	0	14	0	532808	0.000000	0.000000	2117777	1604340
9	0	9	0	532808	0.000000	0.000000	2125037	1610775
9	6	3	1	532808	2.000000	0.333333	2125590	1611282
9	0	9	0	532808	0.000000	0.000000	2110638	1599075
477	364	113	14	532808	3.221239	0.123894	2126228	1617285
495	318	177	11	521174	1.796610	0.062147	2129792	1633700
136	100	36	11	508247	2.777778	0.305556	2133939	1637302
5	0	5	0	527441	0.000000	0.000000	2117452	1603592
104	100	4	6	529312	25.000000	1.500000	2119102	1605049
36	28	8	3	527441	3.500000	0.375000	2120442	1606115
444	411	33	17	527441	12.454545	0.515152	2126915	1619825
95	85	10	7	549288	8.500000	0.700000	2119419	1590682
173	159	14	9	548871	11.357142	0.642857	2121575	1595167
102	81	21	6	539557	3.857143	0.285714	2113643	1589315
83	66	17	6	539557	3.882353	0.352941	2124472	1597646
158	143	15	9	539557	9.533334	0.600000	2130206	1623960
730	685	45	22	518969	15.222222	0.488889	2137253	1640392
289	265	24	15	508247	11.041667	0.625000	2144560	1654675
112	73	39	4	510539	1.871795	0.102564	2116751	1620719
13	8	5	1	510539	1.600000	0.200000	2122782	1625772
11	0	11	0	510539	0.000000	0.000000	2125433	1628032
57	39	18	3	510539	2.166667	0.166667	2127610	1629779
32	16	16	2	510539	1.000000	0.125000	2124742	1627744
296	212	84	9	512220	2.523809	0.107143	2121351	1624507
72	30	42	4	510540	0.714286	0.095238	2128709	1631257
4	0	4	0	511774	0.000000	0.000000	2114989	1619155
115	86	29	6	511774	2.965517	0.206897	2129098	1630203
539	481	58	17	536083	8.293103	0.293103	2118059	1620897
93	62	31	4	511312	2.000000	0.129032	2128072	1629726
21	6	15	1	511312	0.400000	0.066667	2134247	1635025
43	27	16	2	511312	1.687500	0.125000	2134339	1635057
101	68	33	3	511312	2.060606	0.090909	2136594	1638067
57	36	21	5	510540	1.714286	0.238095	2139285	1640537
47	31	16	3	510540	1.937500	0.187500	2140388	1641351
66	44	22	4	510540	2.000000	0.181818	2140851	1641699
366	309	57	18	510540	5.421052	0.315789	2141488	1651678
87	52	35	4	500823	1.485714	0.114286	2147222	1657073
301	255	46	13	500717	5.543478	0.282609	2147226	1657370
65	44	21	4	500424	2.095238	0.190476	2148376	1658381
784	533	251	17	500424	2.123506	0.067729	2148433	1668275
955	755	200	24	490587	3.775000	0.120000	2155888	1719467
111	37	74	5	449150	0.500000	0.067568	2126284	1693232
281	190	91	14	448377	2.087912	0.153846	2129077	1697470
263	192	71	11	446451	2.704225	0.154930	2156205	1724437
1620	1297	323	43	441621	4.015480	0.133127	2156505	1807682
193	169	24	6	485831	7.041667	0.250000	2133625	1654897
299	196	103	9	482989	1.902913	0.087379	2137174	1661406
1151	908	243	22	479764	3.736625	0.090535	2141786	1724026
343	273	70	13	476213	3.900000	0.185714	2182622	1743893
200	159	41	10	442976	3.878049	0.243902	2186915	1747956
509	458	51	17	442976	8.980392	0.333333	2198051	1770927
440	378	62	16	430905	6.096774	0.258065	2198746	1780727
938	727	211	28	421565	3.445498	0.132701	2203087	1822359
851	714	137	18	500534	5.211679	0.131387	2110114	1660187
305	221	84	11	459288	2.630952	0.130952	2123727	1676944
286	227	59	9	529352	3.847458	0.152542	2125750	1612776
155	136	19	3	573336	7.157895	0.157895	2120650	1579905
442	387	55	19	560590	7.036364	0.345455	2122310	1609383
93	54	39	7	522377	1.384615	0.179487	2128070	1614553
46	4	42	1	522119	0.095238	0.023810	2129478	1615948
1167	937	230	27	522119	4.073913	0.117391	2136327	1687924
1915	1374	541	29	455770	2.539741	0.053604	2140217	1710746
18	0	18	0	446311	0.000000	0.000000	2125348	1688071
1230	795	435	23	446311	1.827586	0.052874	2131120	1702244
2266	1613	653	30	436500	2.470138	0.045942	2153224	1772344
1048	759	289	22	383388	2.626297	0.076125	2212371	1863421
2621	1576	1045	34	351294	1.508134	0.032536	2216978	1954695
662	597	65	20	519656	9.184615	0.307692	2174991	1705059
33	21	12	1	486761	1.750000	0.083333	2169058	1701206
90	61	29	6	480572	2.103448	0.206897	2174830	1705725
260	220	40	13	480572	5.500000	0.325000	2186077	1732713
340	219	121	12	462531	1.809917	0.099174	2189292	1758052
817	529	288	22	439931	1.836806	0.076389	2196535	1784259
3249	2246	1003	50	417845	2.239282	0.049850	2199887	1915539
5	0	5	0	498913	0.000000	0.000000	2119032	1632306
886	791	95	21	498913	8.326316	0.221053	2120042	1655724
2	0	2	0	483240	0.000000	0.000000	2124042	1653585
72	66	6	3	483240	11.000000	0.500000	2126556	1662428
35	20	15	2	476496	1.333333	0.133333	2127375	1663225
473	387	86	17	486666	4.500000	0.197674	2120709	1661274
3	0	3	0	476496	0.000000	0.000000	2121745	1658900
92	39	53	6	476496	0.735849	0.113208	2131540	1668041
36	16	20	3	476496	0.800000	0.150000	2135437	1670801
38	16	22	3	476496	0.727273	0.136364	2135850	1671116
33	16	17	3	476496	0.941176	0.176471	2138118	1672147
57	44	13	4	476496	3.384615	0.307692	2138308	1672336
878	721	157	23	476496	4.592357	0.146497	2138744	1729178
4	0	4	0	500916	0.000000	0.000000	2106558	1623226
162	138	24	5	537261	5.750000	0.208333	2174322	1656072
3	0	3	0	532783	0.000000	0.000000	2115348	1602305
6	4	2	1	532783	2.000000	0.500000	2117709	1603964
28	18	10	2	532783	1.800000	0.200000	2179845	1660455
33	22	11	3	533018	2.000000	0.272727	2176154	1657803
3	0	3	0	533018	0.000000	0.000000	2165537	1648450
134	111	23	9	533018	4.826087	0.391304	2181932	1662643
76	60	16	6	533018	3.750000	0.375000	2184790	1663942
43	32	11	3	532917	2.909091	0.272727	2185764	1664878
159	130	29	7	532783	4.482759	0.241379	2189264	1675346
46	20	26	3	525012	0.769231	0.115385	2190731	1676153
0	0	0	0	529150	0.000000	0.000000	2113477	1603903
26	18	8	2	529150	2.250000	0.250000	2121188	1607266
4	0	4	0	528973	0.000000	0.000000	2107960	1599350
10	0	10	0	528973	0.000000	0.000000	2118236	1604907
106	97	9	4	528973	10.777778	0.444444	2126263	1615236
136	122	14	7	525012	8.714286	0.500000	2195411	1689596
56	47	9	3	511950	5.222222	0.333333	2195721	1690946
124	84	40	4	510889	2.100000	0.100000	2197646	1692869
56	49	7	2	511558	7.000000	0.285714	2127489	1631007
96	62	34	3	510889	1.823529	0.088235	2129046	1632323
40	13	27	2	510889	0.481481	0.074074	2200195	1694474
73	59	14	5	510889	4.214286	0.357143	2201490	1695839
1631	1490	141	32	578884	10.567376	0.226950	2107001	1612490
377	328	49	12	510803	6.693878	0.244898	2202928	1706572
59	32	27	4	500916	1.185185	0.148148	2202979	1706623
79	56	23	6	500916	2.434783	0.260870	2203185	1706775
382	291	91	12	500916	3.197802	0.131868	2203252	1706833
8	0	8	0	502058	0.000000	0.000000	2113136	1631083
4	0	4	0	502058	0.000000	0.000000	2118921	1635397
5	0	5	0	502058	0.000000	0.000000	2120918	1635975
126	91	35	8	502058	2.600000	0.228571	2180531	1691571
266	195	71	13	501142	2.746479	0.183099	2184726	1692481
375	295	80	15	500916	3.687500	0.187500	2204984	1717734
215	144	71	5	497590	2.028169	0.070423	2119156	1632057
301	255	46	13	497590	5.543478	0.282609	2126858	1646058
1027	882	145	29	490924	6.082758	0.200000	2206989	1744407
706	524	182	21	477588	2.879121	0.115385	2127948	1675023
950	779	171	26	464922	4.555555	0.152047	2209545	1794787
2778	1933	845	40	416334	2.287574	0.047337	2211608	1918188
1817	1128	689	32	468685	1.637155	0.046444	2125139	1719420
2145	1232	913	33	473741	1.349398	0.036145	2135128	1727470
2571	1635	936	35	416377	1.746795	0.037393	2147017	1820612
0	0	0	0	499598	0.000000	0.000000	2196586	1700636
19	12	7	2	499598	1.714286	0.285714	2202537	1707062
114	96	18	4	503038	5.333333	0.222222	2192114	1697648
65	41	24	2	498925	1.708333	0.083333	2194310	1699730
688	548	140	16	498907	3.914286	0.114286	2206865	1725059
437	339	98	17	488837	3.459184	0.173469	2187400	1707259
1350	1085	265	29	485183	4.094340	0.109434	2210566	1783476
1	0	1	0	528692	0.000000	0.000000	2186967	1665477
1171	870	301	28	528692	2.890365	0.093023	2189241	1690092
1081	746	335	25	505563	2.226866	0.074627	2207634	1734662
551	431	120	16	476716	3.591667	0.133333	2210846	1745648
638	460	178	17	483353	2.584270	0.095506	2188732	1726502
451	356	95	17	468809	3.747368	0.178947	2211081	1754035
924	777	147	25	460658	5.285714	0.170068	2214847	1788887
0	0	0	0	494207	0.000000	0.000000	2198238	1710898
21	17	4	1	494207	4.250000	0.250000	2200178	1712649
101	76	25	5	494207	3.040000	0.200000	2202796	1717648
136	103	33	4	491020	3.121212	0.121212	2205904	1724925
311	279	32	10	486389	8.718750	0.312500	2207897	1735630
871	672	199	23	476308	3.376884	0.115578	2210984	1743742
427	347	80	14	486011	4.337500	0.175000	2198376	1723087
17	7	10	1	482010	0.700000	0.100000	2196371	1720067
15	11	4	1	482010	2.750000	0.250000	2197765	1721383
4	0	4	0	482010	0.000000	0.000000	2198990	1722607
129	57	72	6	482010	0.791667	0.083333	2205353	1728289
288	231	57	15	482010	4.052631	0.263158	2210300	1741500
0	0	0	0	487816	0.000000	0.000000	2204263	1721526
22	11	11	2	487816	1.000000	0.181818	2205731	1722992
14	11	3	1	488024	3.666667	0.333333	2202090	1719650
3	0	3	0	488024	0.000000	0.000000	2203177	1720731
9	6	3	1	488024	2.000000	0.333333	2205822	1722277
9	0	9	0	488024	0.000000	0.000000	2210699	1726808
42	25	17	2	488024	1.470588	0.117647	2210852	1727147
153	118	35	8	487816	3.371428	0.228571	2213359	1743712
710	560	150	22	473486	3.733333	0.146667	2216313	1748969
731	559	172	23	471102	3.250000	0.133721	2221424	1769560
1296	916	380	20	511899	2.410526	0.052632	2191564	1721588
0	0	0	0	472781	0.000000	0.000000	2189606	1722229
531	354	177	13	472781	2.000000	0.073446	2204686	1753167
759	622	137	22	453754	4.540146	0.160584	2222648	1794491
361	280	81	14	429566	3.456790	0.172840	2227575	1799406
662	502	160	23	429548	3.137500	0.143750	2228200	1808461
1	0	1	0	501857	0.000000	0.000000	2188947	1693215
4	0	4	0	501857	0.000000	0.000000	2191253	1695345
3	0	3	0	501857	0.000000	0.000000	2191943	1696031
0	0	0	0	501857	0.000000	0.000000	2192248	1696333
1412	1137	275	36	501857	4.134545	0.130909	2192857	1723610
112	67	45	6	506742	1.488889	0.133333	2177435	1682219
493	357	136	11	506745	2.625000	0.080882	2193680	1720561
2	0	2	0	511559	0.000000	0.000000	2185581	1683086
669	596	73	15	511559	8.164384	0.205479	2185992	1701660
27	13	14	1	574702	0.928571	0.071429	2188039	1621911
1571	1273	298	31	574702	4.271812	0.104027	2188722	1692554
400	256	144	13	501959	1.777778	0.090278	2203469	1715299
289	217	72	11	493395	3.013889	0.152778	2206063	1725931
277	194	83	8	489606	2.337349	0.096386	2189525	1712960
92	43	49	3	485481	0.877551	0.061224	2191710	1715750
27	0	27	0	485115	0.000000	0.000000	2198748	1721790
115	84	31	7	485115	2.709677	0.225806	2210344	1735102
4	0	4	0	524145	0.000000	0.000000	2175821	1662367
1	0	1	0	524145	0.000000	0.000000	2188410	1674308
2	0	2	0	524145	0.000000	0.000000	2190513	1675971
277	247	30	11	524145	8.233334	0.366667	2191940	1693617
0	0	0	0	508714	0.000000	0.000000	2183507	1681158
124	105	19	4	518646	5.526316	0.210526	2189962	1687721
408	349	59	12	508714	5.915254	0.203390	2195615	1693118
1	0	1	0	508174	0.000000	0.000000	2192122	1691667
0	0	0	0	508174	0.000000	0.000000	2193529	1693062
134	105	29	7	508174	3.620690	0.241379	2209739	1707099
136	79	57	4	507926	1.385965	0.070175	2211679	1708553
155	107	48	4	507926	2.229167	0.083333	2211884	1718559
54	23	31	2	498127	0.741935	0.064516	2212601	1718951
123	101	22	3	557917	4.590909	0.136364	2190285	1642794
141	123	18	3	557391	6.833333	0.166667	2185347	1638918
574	492	82	14	556361	6.000000	0.170732	2192968	1681501
8	5	3	1	520938	1.666667	0.333333	2179919	1668872
0	0	0	0	520938	0.000000	0.000000	2189514	1677243
2	0	2	0	520938	0.000000	0.000000	2192769	1680115
1	0	1	0	520938	0.000000	0.000000	2194978	1682001
0	0	0	0	520938	0.000000	0.000000	2196303	1683315
295	230	65	10	520938	3.538461	0.153846	2196657	1684695
404	310	94	11	519913	3.297872	0.117021	2200640	1710318
59	42	17	4	498127	2.470588	0.235294	2214810	1721075
30	25	5	4	501388	5.000000	0.800000	2182928	1690940
24	14	10	2	501541	1.400000	0.200000	2188975	1696588
4	0	4	0	501090	0.000000	0.000000	2190129	1697729
11	0	11	0	501090	0.000000	0.000000	2180436	1688005
1	0	1	0	501090	0.000000	0.000000	2192321	1699513
33	0	33	0	501090	0.000000	0.000000	2192594	1699770
65	27	38	3	501090	0.710526	0.078947	2194893	1704866
18	5	13	1	498127	0.384615	0.076923	2214996	1721259
319	278	41	16	498127	6.780488	0.390244	2215262	1739596
137	94	43	7	480058	2.186047	0.162791	2217677	1741657
1270	932	338	32	480058	2.757396	0.094675	2218574	1748649
2101	1718	383	40	473436	4.485640	0.104439	2224769	1805065
646	460	186	27	420958	2.473118	0.145161	2229143	1854494
1715	1041	674	30	375692	1.544510	0.044510	2229560	1875841
725	597	128	26	527659	4.664062	0.203125	2122625	1626119
779	637	142	26	512360	4.485916	0.183099	2131471	1651354
699	625	74	19	489939	8.445946	0.256757	2138600	1672173
21	5	16	1	518027	0.312500	0.062500	2128024	1626005
54	30	24	4	518027	1.250000	0.166667	2130548	1628577
9	6	3	1	534073	2.000000	0.333333	2117852	1604929
415	315	100	16	534073	3.150000	0.160000	2122391	1621239
767	697	70	18	614204	9.957143	0.257143	2113526	1556927
840	739	101	24	579193	7.316832	0.237624	2119694	1586539
854	757	97	25	554377	7.804124	0.257732	2130559	1626310
330	285	45	14	520436	6.333333	0.311111	2137401	1635331
160	124	36	8	517759	3.444444	0.222222	2141459	1638249
0	0	0	0	527188	0.000000	0.000000	2119125	1612284
289	220	69	15	527188	3.188406	0.217391	2123340	1614327
241	182	59	15	527652	3.084746	0.254237	2128540	1628948
100	58	42	4	517525	1.380952	0.095238	2130862	1629738
0	0	0	0	528536	0.000000	0.000000	2120429	1611310
248	211	37	9	528536	5.702703	0.243243	2129285	1626802
6	0	6	0	519775	0.000000	0.000000	2123987	1622754
0	0	0	0	519779	0.000000	0.000000	2129313	1625003
7	0	7	0	519545	0.000000	0.000000	2118813	1617853
0	0	0	0	519545	0.000000	0.000000	2121358	1619908
1	0	1	0	519779	0.000000	0.000000	2131912	1627310
14	6	8	1	519779	0.750000	0.125000	2137591	1632492
3	0	3	0	519779	0.000000	0.000000	2137787	1632625
163	140	23	8	519779	6.086957	0.347826	2138108	1634961
103	85	18	9	517763	4.722222	0.500000	2141659	1637762
431	387	44	12	517763	8.795455	0.272727	2147607	1647048
842	727	115	25	579235	6.321739	0.217391	2124520	1601122
367	297	70	16	539542	4.242857	0.228571	2130680	1632223
27	16	11	1	519432	1.454545	0.090909	2102367	1602679
18	12	6	1	519432	2.000000	0.166667	2109093	1608507
21	9	12	2	519432	0.750000	0.166667	2116240	1614083
60	37	23	4	519666	1.608696	0.173913	2119821	1616483
9	0	9	0	518771	0.000000	0.000000	2114363	1612860
14	7	7	1	519664	1.000000	0.142857	2120203	1617693
122	95	27	5	519665	3.518518	0.185185	2121917	1618764
209	187	22	6	533990	8.500000	0.272727	2118630	1613959
100	68	32	2	521548	2.125000	0.062500	2123067	1616692
138	96	42	4	521836	2.285714	0.095238	2125675	1621039
1	0	1	0	519448	0.000000	0.000000	2112904	1610764
1	0	1	0	520110	0.000000	0.000000	2118584	1616134
362	319	43	11	522334	7.418605	0.255814	2123311	1619478
46	11	35	2	520348	0.314286	0.057143	2133589	1628834
38	25	13	2	519996	1.923077	0.153846	2133927	1629050
118	107	11	5	519996	9.727273	0.454545	2134344	1629344
425	392	33	6	530442	11.878788	0.181818	2122060	1620428
140	115	25	5	520050	4.600000	0.200000	2135291	1629987
89	61	28	6	520044	2.178571	0.214286	2138626	1632945
52	26	26	4	519725	1.000000	0.153846	2139857	1634035
20	9	11	1	519725	0.818182	0.090909	2140427	1634596
0	0	0	0	544976	0.000000	0.000000	2107712	1583902
0	0	0	0	552515	0.000000	0.000000	2103655	1573182
249	206	43	11	552515	4.790698	0.255814	2113064	1587684
773	751	22	11	544976	34.136364	0.500000	2120699	1603552
21	13	8	2	533869	1.625000	0.250000	2125234	1608440
6	0	6	0	532733	0.000000	0.000000	2125836	1609002
621	595	26	17	532734	22.884615	0.653846	2127023	1622530
13	6	7	1	519725	0.857143	0.142857	2141700	1635390
23	13	10	2	519432	1.300000	0.200000	2113887	1612014
51	23	28	3	519725	0.821429	0.107143	2141743	1635433
589	510	79	15	566782	6.455696	0.189873	2126591	1611574
431	350	81	12	567471	4.320988	0.148148	2118728	1602736
93	27	66	3	532633	0.409091	0.045455	2127396	1610908
0	0	0	0	535524	0.000000	0.000000	2124961	1607799
378	316	62	13	535524	5.096774	0.209677	2132794	1616628
77	61	16	7	532865	3.812500	0.437500	2136917	1619088
360	321	39	15	532821	8.230769	0.384615	2140558	1625279
295	263	32	15	529893	8.218750	0.468750	2140859	1635514
34	14	20	2	519725	0.700000	0.100000	2145116	1638219
246	212	34	7	519725	6.235294	0.205882	2145140	1644052
207	178	29	11	513917	6.137931	0.379310	2146963	1645822
0	0	0	0	524263	0.000000	0.000000	2120025	1612773
0	0	0	0	524926	0.000000	0.000000	2116543	1610119
0	0	0	0	524926	0.000000	0.000000	2123151	1615249
0	0	0	0	524925	0.000000	0.000000	2113730	1605993
2	0	2	0	524925	0.000000	0.000000	2118139	1609699
23	15	8	3	524926	1.875000	0.375000	2127606	1620207
202	182	20	5	525374	9.100000	0.250000	2123733	1617826
82	67	15	5	522780	4.466667	0.333333	2124687	1618657
2	0	2	0	522771	0.000000	0.000000	2119029	1612606
10	7	3	1	522773	2.333333	0.333333	2122401	1615497
8	0	8	0	522539	0.000000	0.000000	2113940	1609819
12	0	12	0	522539	0.000000	0.000000	2120443	1615099
0	0	0	0	522773	0.000000	0.000000	2126455	1618372
3	0	3	0	522773	0.000000	0.000000	2127731	1619587
14	7	7	1	522773	1.000000	0.142857	2128092	1619874
34	17	17	2	522780	1.000000	0.117647	2131764	1623319
8	0	8	0	522781	0.000000	0.000000	2133274	1624707
259	243	16	5	529379	15.187500	0.312500	2126282	1619033
9	0	9	0	522539	0.000000	0.000000	2123022	1617989
21	10	11	2	522539	0.909091	0.181818	2130521	1622923
8	5	3	1	522781	1.666667	0.333333	2136164	1627424
2	0	2	0	522781	0.000000	0.000000	2137794	1628809
2	0	2	0	522781	0.000000	0.000000	2137912	1628920
2	0	2	0	522781	0.000000	0.000000	2138350	1629352
3	0	3	0	522781	0.000000	0.000000	2138477	1629470
1	0	1	0	522781	0.000000	0.000000	2138629	1629616
380	314	66	7	522781	4.757576	0.106061	2138694	1635363
102	55	47	4	516899	1.170213	0.085106	2125193	1624914
205	163	42	10	517100	3.880952	0.238095	2142854	1642289
897	791	106	18	545392	7.462264	0.169811	2123328	1604648
550	461	89	14	535508	5.179775	0.157303	2130309	1631432
282	244	38	10	513624	6.421052	0.263158	2189799	1679298
203	167	36	10	513866	4.638889	0.277778	2199361	1687415
57	33	24	5	513920	1.375000	0.208333	2204332	1691546
96	81	15	2	576352	5.400000	0.133333	2122706	1570838
1386	1180	206	30	576352	5.728155	0.145631	2125147	1620123
591	515	76	16	522738	6.776316	0.210526	2135004	1636715
177	145	32	13	513920	4.531250	0.406250	2206334	1693507
100	67	33	6	572459	2.030303	0.181818	2181288	1617369
287	247	40	7	574169	6.175000	0.175000	2182218	1615411
791	633	158	23	573000	4.006329	0.145570	2191921	1639210
543	411	132	19	557098	3.113636	0.143939	2126162	1586230
732	595	137	24	557994	4.343066	0.175182	2199019	1664143
157	138	19	2	545009	7.263158	0.105263	2124212	1602243
110	87	23	5	537723	3.782609	0.217391	2125357	1604733
45	27	18	3	537723	1.500000	0.166667	2127308	1606366
42	22	20	2	538385	1.100000	0.100000	2131703	1609381
60	25	35	3	538385	0.714286	0.085714	2122856	1601609
53	34	19	4	538385	1.789474	0.210526	2132915	1610813
183	141	42	8	538006	3.357143	0.190476	2203711	1675121
276	198	78	12	543962	2.538461	0.153846	2129667	1612504
8	0	8	0	533550	0.000000	0.000000	2112734	1597762
35	0	35	0	533550	0.000000	0.000000	2115291	1600159
79	51	28	4	533554	1.821429	0.142857	2132192	1614855
0	0	0	0	538009	0.000000	0.000000	2114632	1593008
13	6	7	1	538009	0.857143	0.142857	2121543	1599083
198	178	20	7	538009	8.900000	0.350000	2125056	1602085
36	23	13	4	538980	1.769231	0.307692	2117182	1596230
89	77	12	3	538980	6.416667	0.250000	2125159	1602718
1	0	1	0	556476	0.000000	0.000000	2114774	1576343
0	0	0	0	556476	0.000000	0.000000	2117161	1578078
254	234	20	11	556476	11.700000	0.550000	2121386	1598282
2	0	2	0	538832	0.000000	0.000000	2118841	1596206
3	0	3	0	538832	0.000000	0.000000	2121620	1598777
9	9	0	1	539066	0.000000	0.000000	2126555	1602649
161	112	49	5	548501	2.285714	0.102041	2120888	1601289
8	0	8	0	539066	0.000000	0.000000	2130520	1606190
2	0	2	0	539067	0.000000	0.000000	2131427	1606983
21	10	11	1	539075	0.909091	0.090909	2132274	1607685
196	181	15	7	539075	12.066667	0.466667	2134860	1610257
251	211	40	10	538860	5.275000	0.250000	2136042	1616200
211	167	44	9	533858	3.795455	0.204545	2136801	1616741
14	6	8	1	533555	0.750000	0.125000	2123418	1608090
0	0	0	0	559004	0.000000	0.000000	2122305	1581380
12	5	7	1	559004	0.714286	0.142857	2124402	1582502
140	119	21	9	559004	5.666667	0.428571	2129933	1586792
72	45	27	5	561811	1.666667	0.185185	2116777	1578156
996	963	33	11	558561	29.181818	0.333333	2132103	1613177
414	348	66	7	540853	5.272727	0.106061	2130585	1605187
1	0	1	0	587561	0.000000	0.000000	2110271	1547857
820	785	35	19	587565	22.428572	0.542857	2113809	1590243
75	56	19	6	545467	2.947368	0.315789	2128325	1603837
101	60	41	7	542315	1.463415	0.170732	2130149	1605040
428	359	69	10	541145	5.202899	0.144928	2132076	1606257
495	437	58	10	541145	7.534483	0.172414	2137593	1617993
66	54	12	4	533842	4.500000	0.333333	2140561	1620418
77	46	31	4	533842	1.483871	0.129032	2140651	1620435
84	58	26	5	533843	2.230769	0.192308	2140794	1620503
66	27	39	2	533847	0.692308	0.051282	2142727	1621965
32	12	20	1	533847	0.600000	0.050000	2144174	1623377
167	129	38	6	533847	3.394737	0.157895	2144772	1623886
139	83	56	6	533847	1.482143	0.107143	2144782	1626101
211	134	77	7	531635	1.740260	0.090909	2146599	1627910
321	275	46	15	531635	5.978261	0.326087	2210094	1697938
127	80	47	6	513921	1.702128	0.127660	2215818	1702638
279	220	59	12	513921	3.728814	0.203390	2218513	1706176
231	176	55	10	512896	3.200000	0.181818	2218548	1714483
1101	964	137	24	504589	7.036496	0.175182	2218589	1744260
358	267	91	12	474853	2.934066	0.131868	2220577	1750816
725	589	136	22	470283	4.330883	0.161765	2220657	1784327
3023	2437	586	45	436854	4.158703	0.076792	2222964	1869903
1367	868	499	33	354015	1.739479	0.066132	2230820	1898442
1195	767	428	31	332431	1.792056	0.072430	2230825	1936321
952	469	483	22	294503	0.971014	0.045549	2230886	1945356
1099	607	492	29	285530	1.233740	0.058943	2230886	1967425
892	392	500	19	263465	0.784000	0.038000	2231133	1994295
2288	927	1361	25	236846	0.681117	0.018369	2231133	2054924
1651	623	1028	26	176223	0.606031	0.025292	2231723	2095248
2062	815	1247	24	136451	0.653569	0.019246	2231736	2231736
3346	1210	2136	30	360798	0.566479	0.014045	2139426	1820773
214	123	91	8	445942	1.351648	0.087912	2158834	1728756
757	514	243	17	439692	2.115226	0.069959	2163689	1752451
1337	943	394	24	419473	2.393401	0.060914	2168911	1807564
24	0	24	0	455143	0.000000	0.000000	2094349	1651739
14	6	8	1	455151	0.750000	0.125000	2097177	1654315
769	536	233	24	455384	2.300429	0.103004	2100645	1673573
53	40	13	2	473073	3.076923	0.153846	2145342	1680425
1067	789	278	27	473351	2.838130	0.097122	2147219	1716371
1800	1313	487	34	439430	2.696099	0.069815	2174646	1812244
2927	1114	1813	32	367718	0.614451	0.017650	2186615	1856557
4235	2098	2137	42	333711	0.981750	0.019654	2200343	1982552
16	0	16	0	495368	0.000000	0.000000	2140973	1671182
15	0	15	0	495368	0.000000	0.000000	2144478	1675188
19	0	19	0	495368	0.000000	0.000000	2149480	1678481
27	0	27	0	495368	0.000000	0.000000	2140151	1670431
44	19	25	2	495466	0.760000	0.080000	2146828	1675998
45	11	34	1	495368	0.323529	0.029412	2155885	1684076
113	84	29	4	495368	2.896552	0.137931	2158366	1688972
169	75	94	6	492649	0.797872	0.063830	2161658	1691776
9	0	9	0	492411	0.000000	0.000000	2148481	1680033
32	0	32	0	492411	0.000000	0.000000	2151626	1682442
45	16	29	2	492411	0.551724	0.068966	2152415	1682918
114	56	58	4	492411	0.965517	0.068966	2158844	1688535
152	73	79	6	492411	0.924051	0.075949	2161487	1690277
1712	1330	382	37	492411	3.481675	0.096859	2168562	1757545
1716	1158	558	32	506089	2.075269	0.057348	2152447	1693783
1934	1313	621	33	475899	2.114332	0.053140	2173490	1762761
1186	846	340	28	424190	2.488235	0.082353	2190324	1820774
9	0	9	0	502548	0.000000	0.000000	2153944	1670092
120	103	17	3	502548	6.058824	0.176471	2156536	1671451
3	0	3	0	502548	0.000000	0.000000	2158044	1672911
8	0	8	0	502548	0.000000	0.000000	2159238	1673457
639	517	122	20	502548	4.237705	0.163934	2162145	1702461
537	473	64	17	472793	7.390625	0.265625	2167911	1722134
607	515	92	18	458121	5.597826	0.195652	2169126	1738699
2793	1796	997	33	442638	1.801404	0.033099	2174721	1802174
1131	667	464	19	377623	1.437500	0.040948	2202844	1856961
3330	1752	1578	39	348024	1.110266	0.024715	2205150	1937677
701	530	171	19	491913	3.099415	0.111111	2153800	1708595
0	0	0	0	486108	0.000000	0.000000	2156107	1683246
1	0	1	0	486108	0.000000	0.000000	2160178	1686989
609	422	187	19	486108	2.256685	0.101604	2167669	1716804
2091	1320	771	34	462758	1.712062	0.044099	2177574	1801034
3181	1704	1477	34	385897	1.153690	0.023020	2187018	1846679
2898	1758	1140	41	470748	1.542105	0.035965	2142314	1773539
228	105	123	9	428396	0.853659	0.073171	2154765	1738627
110	0	110	0	427604	0.000000	0.000000	2147035	1731186
416	205	211	9	427639	0.971564	0.042654	2160506	1753144
235	72	163	4	429653	0.441718	0.024540	2149619	1730662
302	57	245	3	429653	0.232653	0.012245	2157382	1738168
232	80	152	9	429653	0.526316	0.059211	2159966	1741498
245	67	178	6	428273	0.376404	0.033708	2163327	1753989
163	101	62	9	419034	1.629032	0.145161	2165094	1756284
159	76	83	5	418447	0.915663	0.060241	2174139	1767947
2192	964	1228	25	415165	0.785016	0.020358	2178940	1805864
3148	1421	1727	33	382388	0.822814	0.019108	2188972	1850236
2126	1034	1092	33	347000	0.946886	0.030220	2202364	1901729
2556	1234	1322	33	305181	0.933434	0.024962	2207545	1940888
1853	891	962	28	269172	0.926195	0.029106	2215837	1995829
2094	867	1227	29	220473	0.706601	0.023635	2216527	2042082
3	0	3	0	371979	0.000000	0.000000	2142695	1783090
6	0	6	0	371979	0.000000	0.000000	2143883	1784240
483	334	149	12	423240	2.241611	0.080537	2144863	1784783
79	51	28	5	371979	1.821429	0.178571	2152492	1791833
29	7	22	1	371423	0.318182	0.045455	2159001	1797966
427	304	123	15	371423	2.471545	0.121951	2160704	1821579
4881	2604	2277	52	349317	1.143610	0.022837	2164313	1932479
34	20	14	2	497315	1.428571	0.142857	2147770	1665810
20	12	8	2	497323	1.500000	0.250000	2154606	1671166
9	6	3	1	497326	2.000000	0.333333	2155629	1672104
1434	1177	257	28	497583	4.579767	0.108949	2158177	1745126
1003	620	383	21	476720	1.618799	0.054830	2156952	1715565
649	533	116	16	454148	4.594828	0.137931	2168438	1731315
43	15	28	3	484444	0.535714	0.107143	2150417	1680896
218	182	36	6	484480	5.055555	0.166667	2155841	1694021
20	0	20	0	484501	0.000000	0.000000	2156854	1686880
170	132	38	10	484539	3.473684	0.263158	2160893	1699043
917	725	192	19	476296	3.776042	0.098958	2165933	1730477
540	421	119	14	449454	3.537815	0.117647	2180413	1765028
296	203	93	11	427245	2.182796	0.118280	2180891	1765353
888	626	262	24	427192	2.389313	0.091603	2186046	1829047
3468	2016	1452	36	362020	1.388430	0.024793	2188562	1878940
855	732	123	24	588216	5.951220	0.195122	2088173	1624125
75	61	14	3	492625	4.357143	0.214286	2086239	1609269
20	18	2	1	490214	9.000000	0.500000	2090143	1613101
97	77	20	5	490234	3.850000	0.250000	2099278	1633149
47	27	20	4	478697	1.350000	0.200000	2102310	1637142
3323	2271	1052	44	477562	2.158745	0.041825	2112430	1758158
11	6	5	1	516348	1.200000	0.200000	2146064	1642420
3592	2447	1145	51	516348	2.137118	0.044541	2149731	1765590
0	0	0	0	537127	0.000000	0.000000	2138934	1613417
4	0	4	0	537131	0.000000	0.000000	2144119	1617488
2638	2150	488	46	537619	4.405738	0.094262	2149275	1707467
28	8	20	1	468669	0.400000	0.050000	2148439	1685935
382	240	142	13	468669	1.690141	0.091549	2153250	1708020
123	40	83	4	485925	0.481928	0.048193	2154570	1682714
623	534	89	26	482039	6.000000	0.292135	2163445	1717590
393	316	77	18	543230	4.103896	0.233766	2150478	1641302
209	150	59	8	525762	2.542373	0.135593	2155133	1644785
0	0	0	0	527264	0.000000	0.000000	2146048	1635701
168	151	17	4	527264	8.882353	0.235294	2151491	1641822
278	220	58	7	527264	3.793103	0.120690	2156779	1645770
97	69	28	5	527264	2.464286	0.178571	2159025	1649281
62	35	27	4	525733	1.296296	0.148148	2168108	1655408
119	83	36	6	532248	2.305556	0.166667	2149459	1639793
475	431	44	14	525733	9.795455	0.318182	2170663	1664977
143	110	33	7	521089	3.333333	0.212121	2129071	1625703
10	0	10	0	525813	0.000000	0.000000	2144042	1633782
56	44	12	2	525813	3.666667	0.166667	2145949	1635333
1	0	1	0	525813	0.000000	0.000000	2140037	1629835
2	0	2	0	525813	0.000000	0.000000	2141727	1630946
85	76	9	4	525813	8.444445	0.444444	2145142	1634189
84	73	11	2	525813	6.636364	0.181818	2151003	1639299
96	75	21	5	525150	3.571429	0.238095	2154223	1642463
35	22	13	2	534255	1.692308	0.153846	2142751	1625543
99	65	34	8	534255	1.911765	0.235294	2146880	1636447
30	17	13	2	525150	1.307692	0.153846	2158821	1646508
236	184	52	11	525150	3.538461	0.211538	2159239	1650988
208	166	42	9	521089	3.952381	0.214286	2163133	1654847
23	7	16	1	577592	0.437500	0.062500	2149881	1592676
8	0	8	0	577304	0.000000	0.000000	2146350	1589003
65	53	12	4	577304	4.416667	0.333333	2150243	1591969
26	25	1	3	577304	25.000000	3.000000	2153521	1595167
11	0	11	0	577304	0.000000	0.000000	2159283	1599348
21	10	11	1	577304	0.909091	0.090909	2159947	1599682
126	97	29	7	577304	3.344828	0.241379	2163336	1601876
20	11	9	2	580749	1.222222	0.222222	2145243	1585548
101	84	17	7	580749	4.941176	0.411765	2149595	1590389
1251	1106	145	37	577304	7.627586	0.255172	2165983	1659241
80	50	30	1	518408	1.666667	0.033333	2175653	1666136
180	146	34	11	518343	4.294117	0.323529	2176100	1666578
526	445	81	22	518343	5.493827	0.271605	2183702	1682545
276	257	19	4	626880	13.526316	0.210526	2148612	1548991
42	25	17	2	623863	1.470588	0.117647	2155135	1554863
55	39	16	2	623863	2.437500	0.125000	2159270	1558362
42	28	14	3	623863	2.000000	0.214286	2160798	1558961
514	435	79	16	623863	5.506329	0.202532	2164801	1566669
14	0	14	0	619407	0.000000	0.000000	2142872	1547754
4	0	4	0	619407	0.000000	0.000000	2142128	1548334
2	0	2	0	619407	0.000000	0.000000	2143608	1549752
55	17	38	2	619407	0.447368	0.052632	2144780	1550682
35	11	24	1	619407	0.458333	0.041667	2146442	1551917
15	13	2	1	619407	6.500000	0.500000	2151354	1554932
12	0	12	0	619407	0.000000	0.000000	2151447	1554994
21	11	10	1	619407	1.100000	0.100000	2152484	1555734
19	9	10	1	619407	0.900000	0.100000	2138427	1543649
101	77	24	6	619407	3.208333	0.250000	2154448	1557238
20	9	11	2	619521	0.818182	0.181818	2137129	1544210
8	0	8	0	619407	0.000000	0.000000	2149608	1553969
3	0	3	0	619407	0.000000	0.000000	2152269	1556158
8	6	2	1	619407	3.000000	0.500000	2156015	1558500
12	5	7	1	619407	0.714286	0.142857	2156059	1558529
25	11	14	2	619407	0.785714	0.142857	2156431	1558729
52	19	33	2	619407	0.575758	0.060606	2150448	1555201
88	68	20	5	619407	3.400000	0.250000	2151491	1556020
45	12	33	2	619407	0.363636	0.060606	2161432	1563096
55	37	18	4	619407	2.055556	0.222222	2163487	1564714
1715	1451	264	46	619407	5.496212	0.174242	2171496	1659657
10	5	5	1	524037	1.000000	0.200000	2141314	1633227
8	0	8	0	524037	0.000000	0.000000	2147691	1637831
295	218	77	13	524037	2.831169	0.168831	2175721	1662337
8	0	8	0	623019	0.000000	0.000000	2150930	1547381
76	51	25	3	623019	2.040000	0.120000	2156037	1556231
34	22	12	1	618611	1.833333	0.083333	2158670	1558321
574	543	31	14	627321	17.516129	0.451613	2151782	1553417
127	113	14	4	618611	8.071428	0.285714	2166160	1564363
1791	1518	273	37	618611	5.560440	0.135531	2170374	1620232
953	809	144	27	564686	5.618055	0.187500	2178964	1666795
662	537	125	22	524037	4.296000	0.176000	2190588	1690831
267	219	48	18	509013	4.562500	0.375000	2201242	1709741
144	114	30	8	497027	3.800000	0.266667	2201864	1709844
1060	963	97	16	497027	9.927835	0.164948	2202471	1732661
96	89	7	6	490390	12.714286	0.857143	2150739	1671885
99	81	18	6	568293	4.500000	0.333333	2134253	1590189
2601	2188	413	48	563387	5.297821	0.116223	2144875	1665272
1087	960	127	30	488138	7.559055	0.236220	2166840	1699076
798	658	140	26	473370	4.700000	0.185714	2204427	1744690
15	0	15	0	509215	0.000000	0.000000	2142361	1647619
968	681	287	26	509215	2.372822	0.090592	2185930	1689436
1629	1273	356	36	508252	3.575843	0.101124	2196829	1735552
81	69	12	3	511130	5.750000	0.250000	2141022	1641219
581	538	43	18	511130	12.511628	0.418605	2144193	1682291
30	13	17	2	471861	0.764706	0.117647	2150510	1688669
42	16	26	3	471861	0.615385	0.115385	2146474	1685074
28	11	17	1	471861	0.647059	0.058824	2159397	1696867
368	268	100	16	471861	2.680000	0.160000	2165554	1708150
649	472	177	18	465729	2.666667	0.101695	2204663	1745940
292	246	46	15	462251	5.347826	0.326087	2219058	1770148
161	88	73	7	451334	1.205480	0.095890	2219141	1770300
205	156	49	13	451257	3.183673	0.265306	2219145	1770877
1172	969	203	29	450685	4.773399	0.142857	2219672	1829826
1765	1095	670	25	392259	1.634328	0.037313	2219874	1859207
2186	1342	844	29	361760	1.590047	0.034360	2223203	1909530
2758	1427	1331	30	313902	1.072126	0.022539	2225133	1952117
3212	1303	1909	30	366458	0.682556	0.015715	2149121	1821241
8	4	4	1	419475	1.000000	0.250000	2140691	1731758
5	0	5	0	429326	0.000000	0.000000	2138242	1720058
61	45	16	4	429326	2.812500	0.250000	2145383	1726446
206	175	31	9	428157	5.645161	0.290323	2149059	1729797
80	57	23	6	427866	2.478261	0.260870	2154573	1739563
104	74	30	4	422482	2.466667	0.133333	2155250	1743155
339	283	56	15	419475	5.053571	0.267857	2157426	1765960
380	297	83	13	398790	3.578313	0.156627	2160001	1788374
3463	1736	1727	36	377986	1.005211	0.020845	2161917	1834670
4058	1848	2210	37	331001	0.836199	0.016742	2183438	1911425
1865	864	1001	27	273196	0.863137	0.026973	2226429	1990275
2296	970	1326	26	236247	0.731523	0.019608	2226625	2051983
1142	331	811	14	174734	0.408138	0.017263	2228213	2066801
322	235	87	9	451667	2.701149	0.103448	2139651	1711469
151	65	86	6	441308	0.755814	0.069767	2146059	1725582
1080	830	250	30	433279	3.320000	0.120000	2158661	1796997
28	19	9	2	377243	2.111111	0.222222	2129606	1764851
114	79	35	3	377243	2.257143	0.085714	2136965	1773069
0	0	0	0	446982	0.000000	0.000000	2131560	1701355
79	57	22	3	446982	2.590909	0.136364	2128966	1699615
1376	1141	235	25	446982	4.855319	0.106383	2137251	1772796
457	378	79	16	376197	4.784810	0.202532	2153535	1793414
453	336	117	11	370440	2.871795	0.094017	2169784	1810884
166	146	20	10	456916	7.300000	0.500000	2133105	1706706
205	161	44	7	440535	3.659091	0.159091	2137382	1718254
1188	1010	178	27	433124	5.674157	0.151685	2141398	1784397
1244	751	493	25	366934	1.523327	0.050710	2176043	1859075
3356	1387	1969	30	324450	0.704418	0.015236	2189584	1922065
0	0	0	0	412899	0.000000	0.000000	2151044	1748122
6	0	6	0	412899	0.000000	0.000000	2156782	1753515
219	141	78	5	412899	1.807692	0.064103	2158585	1755868
133	63	70	8	412356	0.900000	0.114286	2160258	1759215
1622	988	634	28	412293	1.558360	0.044164	2170799	1841878
4180	1921	2259	38	334669	0.850376	0.016822	2180431	1913306
4542	2195	2347	45	271500	0.935236	0.019173	2206753	2045540
1237	298	939	12	161496	0.317359	0.012780	2228702	2087313
510	200	310	5	352555	0.645161	0.016129	2100524	1774789
4666	2019	2647	43	338192	0.762750	0.016245	2148564	1873210
3367	1648	1719	38	387322	0.958697	0.022106	2109134	1806799
3628	1465	2163	34	351358	0.677300	0.015719	2088283	1779709
3886	1546	2340	34	316244	0.660684	0.014530	2177587	1896086
4051	2270	1781	45	285006	1.274565	0.025267	2199053	2058315
1137	303	834	11	141473	0.363309	0.013189	2228900	2094001
4563	1874	2689	37	219226	0.696913	0.013760	2184870	2051383
2056	871	1185	23	134986	0.735021	0.019409	2228951	2228951
0	0	0	0	0	0.000000	0.000000	2232025	2232025
