Node	Total SNPs	Num of SNPs inside recombinations	Num of SNPs outside recombinations	Num of Recombination Blocks	Bases in Recombinations	r/m	rho/theta	Genome Length	Bases in Clonal Frame
ERR1204772	0	0	0	0	544513	0	0	2112638	1588433
ERR1204773	164	116	48	8	439132	2.416667	0.166667	2095334	1676293
ERR1204774	13	0	13	0	495368	0	0	2138023	1669666
ERR1204775	61	43	18	2	492411	2.388889	0.111111	2140750	1672590
ERR1204776	13	7	6	1	446311	1.166667	0.166667	2122836	1685959
ERR1204777	541	476	65	19	461439	7.323077	0.292308	2091324	1665818
ERR1204778	31	27	4	2	498913	6.75	0.5	2114799	1628177
ERR1204779	0	0	0	0	527441	0	0	2114159	1601225
ERR1204780	7	5	2	1	495368	2.5	0.5	2133697	1666629
ERR1204781	38	27	11	2	505107	2.454545	0.181818	2138063	1668565
ERR1204782	0	0	0	0	481410	0	0	2150766	1677937
ERR1204783	0	0	0	0	533018	0	0	2112593	1598195
ERR1204784	10	6	4	1	453724	1.5	0.25	2151600	1706548
ERR1204785	8	5	3	1	619407	1.666667	0.333333	2135047	1544518
ERR1204786	10	5	5	1	551853	1	0.2	2108443	1578286
ERR1204787	0	0	0	0	527441	0	0	2109939	1597197
ERR1204788	1774	876	898	26	491535	0.975501	0.028953	2113130	1653966
ERR1204789	62	40	22	5	556920	1.818182	0.227273	2154161	1609695
ERR1204790	175	154	21	4	478089	7.333333	0.190476	2138424	1677141
ERR1204791	468	410	58	10	529071	7.068965	0.172414	2106737	1612002
ERR1204792	457	323	134	13	372222	2.410448	0.097015	2146914	1810521
ERR1204793	0	0	0	0	495466	0	0	2136825	1667061
ERR1204794	24	10	14	2	507610	0.714286	0.142857	2105318	1612239
ERR1204795	129	104	25	2	540056	4.16	0.08	2160146	1639782
ERR1204796	737	463	274	20	494056	1.689781	0.072993	2128491	1671168
ERR1204797	9	7	2	1	495368	3.5	0.5	2137622	1669079
ERR1204798	31	0	31	0	420594	0	0	2153568	1738666
ERR1204801	49	24	25	3	445851	0.96	0.12	2140807	1705083
ERR1204802	0	0	0	0	522377	0	0	2111743	1599522
ERR1204803	0	0	0	0	437859	0	0	2092005	1670728
ERR1204804	14	0	14	0	448389	0	0	2158130	1717238
ERR1204805	0	0	0	0	483240	0	0	2110292	1642575
ERR1204806	21	21	0	2	459571	0	0	2155019	1704174
ERR1204807	134	109	25	3	543614	4.36	0.12	2133048	1618945
ERR1204812	17	14	3	2	424232	4.666667	0.666667	2147924	1738568
ERR1204813	0	0	0	0	529492	0	0	2113360	1602836
ERR2631822	5	0	5	0	525813	0	0	2125663	1619002
ERR2631824	103	49	54	4	435470	0.907407	0.074074	2131832	1715714
ERR2631828	16	0	16	0	619407	0	0	2126839	1536727
ERR2631829	0	0	0	0	459288	0	0	2108136	1659539
ERR2631830	47	22	25	2	619407	0.88	0.08	2133981	1543891
ERR2631731	65	5	60	1	455151	0.083333	0.016667	2066442	1628671
ERR2631831	555	421	134	17	427244	3.141791	0.126866	2124967	1762829
ERR2631833	2439	980	1459	31	261387	0.671693	0.021247	2142718	1930495
ERR2631834	0	0	0	0	508714	0	0	2180830	1678920
ERR2631835	0	0	0	0	500916	0	0	2095051	1613262
ERR2631836	12	0	12	0	500916	0	0	2099823	1617093
ERR2631837	0	0	0	0	520110	0	0	2105989	1605714
ERR2631838	40	0	40	0	387322	0	0	2101687	1738671
ERR2631840	7	7	0	1	519541	0	0	2110293	1612447
ERR2631732	3	0	3	0	491913	0	0	2142597	1671320
ERR2631841	60	45	15	4	451066	3	0.266667	2142144	1700886
ERR2631843	293	211	82	9	451882	2.573171	0.109756	2140560	1710592
ERR2631844	0	0	0	0	508714	0	0	2181353	1679453
ERR2631845	0	0	0	0	521547	0	0	2104186	1601706
ERR2631846	61	0	61	0	427585	0	0	2132448	1719220
ERR2631847	5	0	5	0	619407	0	0	2126945	1539191
ERR2631848	0	0	0	0	619407	0	0	2129440	1539126
ERR2631849	1093	805	288	23	490780	2.795139	0.079861	2139326	1701855
ERR2631733	205	176	29	11	531914	6.068965	0.37931	2113183	1618204
ERR2631853	0	0	0	0	502548	0	0	2134361	1653821
ERR2631854	5	0	5	0	502548	0	0	2137683	1656431
ERR2631855	43	19	24	2	530943	0.791667	0.083333	2108260	1598829
ERR2631857	1422	1385	37	10	552218	37.432434	0.27027	2107935	1600283
ERR2631858	4	0	4	0	511774	0	0	2108470	1614411
ERR2631859	716	475	241	19	398511	1.970954	0.078838	2068182	1727273
ERR2631860	5	0	5	0	468669	0	0	2132255	1671221
ERR2631861	7	0	7	0	533018	0	0	2159798	1644814
ERR2631734	6	0	6	0	360798	0	0	2125518	1781750
ERR2631862	5	0	5	0	587273	0	0	2100700	1539682
ERR2631863	11	5	6	1	588093	0.833333	0.166667	2081732	1518445
ERR2631864	0	0	0	0	519432	0	0	2097770	1598713
ERR2631865	0	0	0	0	521089	0	0	2123494	1620784
ERR2631867	0	0	0	0	587020	0	0	2105178	1543993
ERR2631868	0	0	0	0	483243	0	0	2140835	1670404
ERR2631869	613	565	48	11	552380	11.770833	0.229167	2107628	1585229
ERR2631870	1503	1278	225	36	620837	5.68	0.16	2153176	1642809
ERR2631871	198	164	34	6	468106	4.823529	0.176471	2148737	1699727
ERR2631735	6	0	6	0	413739	0	0	2151581	1744188
ERR2631872	0	0	0	0	495368	0	0	2127501	1660610
ERR2631873	6	0	6	0	522539	0	0	2109841	1606447
ERR2631874	54	28	26	3	455602	1.076923	0.115385	2148096	1704416
ERR2631875	19	10	9	1	580749	1.111111	0.111111	2125439	1572295
ERR2631876	489	365	124	6	429353	2.943548	0.048387	2137203	1739143
ERR2631877	43	0	43	0	387322	0	0	2102522	1737899
ERR2631878	487	473	14	11	525316	33.785713	0.785714	2097108	1597588
ERR2631879	11	8	3	1	587277	2.666667	0.333333	2106428	1544926
ERR2631880	38	9	29	1	437859	0.310345	0.034483	2074921	1655255
ERR2631881	36	15	21	2	457279	0.714286	0.095238	2146097	1698128
ERR2631736	2	0	2	0	503038	0	0	2189986	1693110
ERR2631883	90	71	19	2	521299	3.736842	0.105263	2103814	1601568
ERR2631884	6	0	6	0	511774	0	0	2111110	1615696
ERR2631885	0	0	0	0	552515	0	0	2099887	1570620
ERR2631886	11	0	11	0	619407	0	0	2129652	1540342
ERR2631887	0	0	0	0	488837	0	0	2184785	1701423
ERR2631888	0	0	0	0	488837	0	0	2179056	1695690
ERR2631889	271	239	32	11	500331	7.46875	0.34375	2158862	1691844
ERR2631890	12	0	12	0	488024	0	0	2189556	1707539
ERR2631891	1435	1184	251	33	594266	4.717132	0.131474	2126912	1606939
ERR2631737	0	0	0	0	498925	0	0	2183848	1689614
ERR2631893	8	0	8	0	577304	0	0	2126195	1575818
ERR2631894	0	0	0	0	453645	0	0	2146651	1702371
ERR2631895	8	5	3	1	614204	1.666667	0.333333	2107523	1518173
ERR2631896	28	20	8	2	619521	2.5	0.25	2127825	1538294
ERR2631897	0	0	0	0	429058	0	0	2085359	1673591
ERR2631898	12	0	12	0	556386	0	0	2142399	1600920
ERR2631899	0	0	0	0	524263	0	0	2106752	1600381
ERR2631900	0	0	0	0	520938	0	0	2175013	1664166
ERR2631901	334	226	108	12	497093	2.092592	0.111111	2086842	1620986
ERR2631738	28	13	15	2	519656	0.866667	0.133333	2155133	1649155
ERR2631902	113	96	17	8	620117	5.647059	0.470588	2123952	1532282
ERR2631903	838	591	247	23	403251	2.392713	0.093117	2070227	1729316
ERR2631904	0	0	0	0	579193	0	0	2105522	1553590
ERR2631905	0	0	0	0	522539	0	0	2109883	1606601
ERR2631906	0	0	0	0	457607	0	0	2144568	1695853
ERR2631907	0	0	0	0	453645	0	0	2144791	1701136
ERR2631910	1	0	1	0	532808	0	0	2102071	1592154
ERR2631911	0	0	0	0	453645	0	0	2142049	1698435
ERR2631739	0	0	0	0	503038	0	0	2186047	1691086
ERR2631740	4	0	4	0	371979	0	0	2136986	1778231
ERR2631742	34	29	5	1	522539	5.8	0.2	2104485	1601256
ERR2631743	0	0	0	0	453645	0	0	2145828	1702303
ERR2631744	16	9	7	1	372020	1.285714	0.142857	2134314	1775219
ERR2631745	2	0	2	0	449150	0	0	2120600	1688440
ERR2631746	783	664	119	24	553310	5.579832	0.201681	2104755	1587443
ERR2631747	0	0	0	0	513624	0	0	2163074	1659222
ERR2631748	483	387	96	14	409715	4.03125	0.145833	2080668	1693045
ERR2631749	0	0	0	0	413739	0	0	2149003	1741831
ERR2631750	0	0	0	0	445940	0	0	2143933	1709565
ERR2631723	0	0	0	0	456819	0	0	2139181	1701343
ERR2631751	58	43	15	3	453416	2.866667	0.2	2149416	1714741
ERR2631752	8	7	1	1	453645	7	1	2144822	1700106
ERR2631753	0	0	0	0	413739	0	0	2147248	1739685
ERR2631754	0	0	0	0	524145	0	0	2173192	1660210
ERR2631755	92	84	8	3	482010	10.5	0.375	2191561	1715784
ERR2631756	27	19	8	2	532808	2.375	0.25	2100917	1591094
ERR2631757	0	0	0	0	518770	0	0	2098867	1600522
ERR2631758	11	0	11	0	446311	0	0	2115950	1680183
ERR2631759	20	4	16	1	532783	0.25	0.0625	2096764	1588942
ERR2631760	43	0	43	0	448389	0	0	2149439	1710648
ERR2631724	18	4	14	1	521089	0.285714	0.071429	2123205	1621106
ERR2631761	0	0	0	0	619407	0	0	2130044	1538918
ERR2631762	13	5	8	1	409886	0.625	0.125	2142682	1746017
ERR2631763	6	0	6	0	409886	0	0	2140271	1743826
ERR2631764	0	0	0	0	501857	0	0	2178151	1686308
ERR2631765	560	466	94	15	442400	4.957447	0.159574	2146947	1727271
ERR2631766	0	0	0	0	441809	0	0	2146981	1715656
ERR2631767	846	794	52	20	484290	15.269231	0.384615	2144578	1714219
ERR2631768	5	5	0	1	371979	0	0	2137782	1778378
ERR2631769	1142	969	173	28	484256	5.601156	0.16185	2088535	1676582
ERR2631770	0	0	0	0	413739	0	0	2144920	1737996
ERR2631725	539	464	75	17	516523	6.186666	0.226667	2188711	1707236
ERR2631771	222	204	18	9	455463	11.333333	0.5	2144605	1708728
ERR2631772	0	0	0	0	451485	0	0	2148489	1706112
ERR2631773	235	205	30	7	497950	6.833333	0.233333	2136720	1657624
ERR2631774	296	253	43	11	546538	5.883721	0.255814	2100138	1589155
ERR2631775	93	86	7	1	525813	12.285714	0.142857	2119519	1615207
ERR2631776	0	0	0	0	527441	0	0	2103953	1593975
ERR2631777	98	82	16	3	511317	5.125	0.1875	2105447	1621732
ERR2631778	43	21	22	2	576118	0.954545	0.090909	2105593	1557462
ERR2631779	5	5	0	1	527188	0	0	2101992	1595750
ERR2631780	0	0	0	0	483353	0	0	2185938	1708993
ERR2631781	11	5	6	1	529379	0.833333	0.166667	2111841	1600529
ERR2631782	0	0	0	0	415941	0	0	2143794	1735007
ERR2631783	11	11	0	1	538009	0	0	2109507	1588597
ERR2631784	198	157	41	10	529229	3.829268	0.243902	2105328	1603461
ERR2631785	8	6	2	1	389437	3	0.5	2146205	1771978
ERR2631786	69	22	47	3	448389	0.468085	0.06383	2150184	1711452
ERR2631727	0	0	0	0	556386	0	0	2145606	1602133
ERR2631794	217	172	45	14	468728	3.822222	0.311111	2081524	1645670
ERR2631795	14	4	10	1	417308	0.4	0.1	2141504	1734058
ERR2631796	384	331	53	18	407269	6.245283	0.339623	2146690	1777011
ERR2631797	0	0	0	0	502058	0	0	2097771	1616486
ERR2631798	129	118	11	4	520420	10.727273	0.363636	2171435	1680461
ERR2631799	1	0	1	0	495368	0	0	2131158	1662624
ERR2631800	0	0	0	0	544976	0	0	2103405	1581142
ERR2631728	0	0	0	0	442976	0	0	2111682	1674798
ERR2631801	1	0	1	0	544976	0	0	2101913	1578631
ERR2631802	0	0	0	0	497301	0	0	2133177	1653833
ERR2631803	0	0	0	0	501857	0	0	2177625	1684813
ERR2631807	715	527	188	18	502140	2.803191	0.095745	2116375	1642284
ERR2631808	0	0	0	0	531971	0	0	2104548	1593102
ERR2631809	197	111	86	7	534940	1.290698	0.081395	2093918	1585938
ERR2631810	4	0	4	0	492411	0	0	2131142	1663624
ERR2631729	4	0	4	0	539557	0	0	2110260	1586590
ERR2631811	0	0	0	0	527264	0	0	2126983	1622146
ERR2631812	0	0	0	0	416946	0	0	2139683	1734882
ERR2631813	997	727	270	26	518458	2.692593	0.096296	2127078	1668639
ERR2631814	28	5	23	1	429681	0.217391	0.043478	2130308	1714984
ERR2631815	1	0	1	0	451485	0	0	2149664	1707724
ERR2631816	0	0	0	0	614204	0	0	2106327	1516975
ERR2631817	0	0	0	0	486108	0	0	2142278	1671876
ERR2631818	0	0	0	0	574702	0	0	2176185	1612833
ERR2631819	3310	1652	1658	33	376805	0.996381	0.019903	2135778	1840503
ERR2631730	0	0	0	0	538009	0	0	2108658	1587831
ERR2632011	135	112	23	3	489238	4.869565	0.130435	2156861	1684498
ERR2632012	0	0	0	0	448389	0	0	2145660	1706682
ERR2632013	5	0	5	0	423181	0	0	2150557	1737748
ERR2632014	0	0	0	0	449150	0	0	2119545	1686554
ERR2632015	0	0	0	0	529312	0	0	2107085	1592070
ERR2632016	32	13	19	2	511653	0.684211	0.105263	2110866	1615169
ERR2632017	7	5	2	1	519432	2.5	0.5	2095318	1598950
ERR2632018	8	0	8	0	538832	0	0	2107215	1586748
ERR2632019	1	0	1	0	524925	0	0	2106771	1602120
ERR2632020	1367	1138	229	22	590597	4.969432	0.09607	2105381	1623482
ERR2631921	0	0	0	0	529150	0	0	2100062	1592601
ERR2632021	320	164	156	6	429234	1.051282	0.038462	2126878	1717474
ERR2632022	1250	980	270	33	515372	3.62963	0.122222	2118668	1700426
ERR2632026	28	10	18	2	484531	0.555556	0.111111	2137778	1671197
ERR2632028	1	0	1	0	352555	0	0	2087446	1748571
ERR2631922	17	11	6	1	429058	1.833333	0.166667	2081355	1670464
ERR2632033	0	0	0	0	577304	0	0	2133325	1580106
ERR2632034	0	0	0	0	577304	0	0	2134555	1580599
ERR2632035	3	0	3	0	623863	0	0	2127522	1532793
ERR2632036	153	117	36	3	497590	3.25	0.083333	2099914	1618787
ERR2632037	105	97	8	7	486150	12.125	0.875	2183693	1707159
ERR2632038	4	0	4	0	518171	0	0	2099327	1598072
ERR2632039	32	6	26	1	519758	0.230769	0.038462	2104264	1605723
ERR2632040	7	0	7	0	588093	0	0	2081061	1515680
ERR2631923	14	6	8	1	481440	0.75	0.125	2144197	1672927
ERR2632041	352	326	26	7	524245	12.538462	0.269231	2104939	1605320
ERR2632042	203	185	18	6	487344	10.277778	0.333333	2105323	1639228
ERR2632043	0	0	0	0	538383	0	0	2105945	1587088
ERR2632044	33	33	0	2	538383	0	0	2105162	1586703
ERR2631924	5	0	5	0	435395	0	0	2144464	1716541
ERR2631925	51	6	45	1	468999	0.133333	0.022222	2107894	1652095
ERR2631926	0	0	0	0	532808	0	0	2100807	1590665
ERR2631927	775	665	110	22	556475	6.045455	0.2	2102700	1619700
ERR2631928	0	0	0	0	472781	0	0	2187741	1720389
ERR2631929	0	0	0	0	564686	0	0	2128978	1588272
ERR2631930	0	0	0	0	472781	0	0	2185260	1718621
ERR2631912	53	35	18	2	507545	1.944444	0.111111	2135975	1654668
ERR2631931	117	81	36	5	532953	2.25	0.138889	2106497	1592670
ERR2631932	13	0	13	0	478664	0	0	2146370	1677117
ERR2631933	262	232	30	5	388319	7.733333	0.166667	2116083	1752654
ERR2631934	0	0	0	0	423181	0	0	2149102	1735692
ERR2631935	0	0	0	0	518646	0	0	2179608	1668768
ERR2631936	193	155	38	5	479280	4.078948	0.131579	2102761	1643285
ERR2631937	108	78	30	2	425235	2.6	0.066667	2136043	1725291
ERR2631938	0	0	0	0	413739	0	0	2145118	1737489
ERR2631939	6	0	6	0	413739	0	0	2145810	1738476
ERR2631913	995	743	252	30	419117	2.948413	0.119048	2132136	1764341
ERR2631941	0	0	0	0	556476	0	0	2105350	1567694
ERR2631942	147	121	26	9	586535	4.653846	0.346154	2135845	1582615
ERR2631947	15	9	6	1	482010	1.5	0.166667	2189970	1714090
ERR2631949	2	0	2	0	619407	0	0	2134052	1542203
ERR2631950	40	21	19	3	452366	1.105263	0.157895	2149089	1705753
ERR2631914	0	0	0	0	429058	0	0	2082131	1671287
ERR2631951	0	0	0	0	495368	0	0	2131076	1662917
ERR2631952	12	6	6	1	511130	1	0.166667	2126141	1629553
ERR2631953	0	0	0	0	442747	0	0	2077103	1657004
ERR2631954	5	0	5	0	478475	0	0	2144770	1674354
ERR2631955	10	0	10	0	442246	0	0	2080027	1656856
ERR2631956	1	0	1	0	429058	0	0	2085541	1674345
ERR2631957	0	0	0	0	522539	0	0	2104015	1603473
ERR2631958	0	0	0	0	449614	0	0	2142210	1703200
ERR2631959	0	0	0	0	533018	0	0	2156633	1640335
ERR2631960	31	19	12	2	568185	1.583333	0.166667	2107777	1577086
ERR2631915	1153	943	210	23	584967	4.490476	0.109524	2105711	1590606
ERR2631962	7	6	1	1	413739	6	1	2144005	1737214
ERR2631963	268	174	94	8	537118	1.851064	0.085106	2102791	1606143
ERR2631964	10	0	10	0	423181	0	0	2148631	1734042
ERR2631965	1	0	1	0	501857	0	0	2178371	1686075
ERR2631966	0	0	0	0	552515	0	0	2099844	1571327
ERR2631967	4	0	4	0	539557	0	0	2107309	1584649
ERR2631968	2	0	2	0	619407	0	0	2128389	1539360
ERR2631969	546	499	47	6	473945	10.617022	0.12766	2140496	1703187
ERR2631970	5	0	5	0	501090	0	0	2174089	1682225
ERR2631916	39	33	6	3	421204	5.5	0.5	2151808	1737411
ERR2631971	6	0	6	0	501857	0	0	2175535	1683541
ERR2631972	39	27	12	2	520938	2.25	0.166667	2171185	1660189
ERR2631973	2	0	2	0	330304	0	0	2093705	1776970
ERR2631974	0	0	0	0	463605	0	0	2145960	1702956
ERR2631975	50	34	16	2	516348	2.125	0.125	2126271	1627740
ERR2631976	0	0	0	0	435395	0	0	2146046	1716769
ERR2631977	0	0	0	0	498913	0	0	2103379	1620404
ERR2631978	0	0	0	0	463605	0	0	2144458	1700473
ERR2631979	63	46	17	3	384000	2.705882	0.176471	2137379	1761000
ERR2631980	1678	1408	270	35	514179	5.214815	0.12963	2190200	1735976
ERR2631917	117	113	4	7	539015	28.25	1.75	2114104	1601444
ERR2631981	1169	887	282	30	481983	3.14539	0.106383	2110280	1689133
ERR2631982	0	0	0	0	619521	0	0	2131519	1541024
ERR2631983	78	55	23	3	507989	2.391304	0.130435	2173943	1675042
ERR2631984	0	0	0	0	562974	0	0	2127820	1583946
ERR2631985	0	0	0	0	482010	0	0	2187967	1711893
ERR2631986	0	0	0	0	448477	0	0	2148080	1710311
ERR2631987	1	0	1	0	330304	0	0	2098538	1779785
ERR2631988	0	0	0	0	330304	0	0	2102272	1783972
ERR2631989	13	0	13	0	524145	0	0	2173592	1660255
ERR2631918	1321	1092	229	24	478020	4.768559	0.104803	2094585	1677291
ERR2631991	0	0	0	0	478664	0	0	2146301	1676943
ERR2631992	0	0	0	0	330304	0	0	2099681	1780977
ERR2631993	266	251	15	5	559318	16.733334	0.333333	2111594	1591640
ERR2631994	0	0	0	0	441809	0	0	2145428	1715707
ERR2631995	6	5	1	1	519541	5	1	2109687	1610962
ERR2631996	341	211	130	12	528343	1.623077	0.092308	2106314	1602519
ERR2631997	8	6	2	1	482010	3	0.5	2189704	1714618
ERR2631998	2380	1790	590	40	512095	3.033898	0.067797	2096577	1697021
ERR2631999	714	548	166	22	395050	3.301205	0.13253	2089519	1732464
ERR2632000	2130	1347	783	37	500092	1.720307	0.047254	2096093	1642853
ERR2631919	0	0	0	0	532808	0	0	2102466	1593679
ERR2632001	2	0	2	0	524925	0	0	2109554	1603690
ERR2632002	218	213	5	3	495357	42.599998	0.6	2192396	1707151
ERR2632003	118	94	24	7	478276	3.916667	0.291667	2107523	1644756
ERR2632004	78	76	2	2	501924	38	1	2101253	1612182
ERR2632005	11	0	11	0	518171	0	0	2098970	1598784
ERR2632006	0	0	0	0	423240	0	0	2139405	1728451
ERR2632007	0	0	0	0	538980	0	0	2108481	1591382
ERR2632008	97	42	55	6	450169	0.763636	0.109091	2104343	1675272
ERR2632009	586	458	128	21	512119	3.578125	0.164062	2103693	1610867
ERR2632010	159	101	58	5	623863	1.741379	0.086207	2130042	1533224
ERR2631920	110	60	50	6	448389	1.2	0.12	2146286	1707442
ERR1837103	0	0	0	0	524037	0	0	2138633	1631624
ERR1837104	0	0	0	0	527264	0	0	2143776	1634798
ERR1837105	5	0	5	0	520938	0	0	2188683	1676802
ERR1837106	13	8	5	1	429326	1.6	0.2	2136052	1718142
ERR1837107	1	0	1	0	492611	0	0	2080211	1601165
ERR1837109	26	21	5	3	536845	4.2	0.6	2151217	1625285
ERR1837110	0	0	0	0	412356	0	0	2145358	1748392
ERR1837111	5	5	0	1	442802	0	0	2097246	1674382
ERR1837112	26	0	26	0	428396	0	0	2150042	1734847
ERR1837113	1151	583	568	21	352934	1.026408	0.036972	2151152	1827998
ERR1837114	190	131	59	7	440012	2.220339	0.118644	2142152	1712518
ERR1837115	213	152	61	10	543296	2.491803	0.163934	2119087	1592528
ERR1837116	0	0	0	0	516348	0	0	2135548	1633071
ERR1837117	3	0	3	0	462125	0	0	2090226	1648510
ERR1837118	10	0	10	0	557098	0	0	2121173	1582420
ERR1837119	8	7	1	1	524037	7	1	2136449	1629669
ERR1837120	0	0	0	0	518171	0	0	2112428	1609087
ERR1837121	9	7	2	1	485637	3.5	0.5	2189668	1713555
ERR1837122	6	0	6	0	544113	0	0	2114612	1587818
ERR1837123	0	0	0	0	443021	0	0	2093969	1670738
ERR1837125	0	0	0	0	534255	0	0	2134979	1620091
ERR1837126	3	0	3	0	492611	0	0	2082553	1603259
ERR1837127	169	129	40	9	439748	3.225	0.225	2137299	1719574
ERR1837128	3	0	3	0	557917	0	0	2184358	1635920
ERR1837129	8	0	8	0	521877	0	0	2112494	1610152
ERR1837130	0	0	0	0	536845	0	0	2148661	1622917
ERR1837131	5	0	5	0	540191	0	0	2124961	1600186
ERR1837132	111	55	56	5	489375	0.982143	0.089286	2145870	1671058
ERR1837133	0	0	0	0	525813	0	0	2137911	1628659
ERR2632045	0	0	0	0	534255	0	0	2136280	1621561
ERR1837102	75	68	7	5	510539	9.714286	0.714286	2119389	1623086
ERR3200821	1212	1081	131	29	503869	8.251908	0.221374	2157602	1715672
ERR3200822	13	6	7	1	533839	0.857143	0.142857	2114932	1600658
ERR3200824	1	0	1	0	568275	0	0	2131226	1583538
ERR3200825	21	11	10	1	501142	1.1	0.1	2112242	1627818
ERR3200826	2	0	2	0	446982	0	0	2123390	1695034
ERR3200860	473	401	72	12	461688	5.569445	0.166667	2149717	1709086
ERR3200861	0	0	0	0	560590	0	0	2109621	1570336
ERR3200862	97	67	30	4	522984	2.233333	0.133333	2113593	1609735
ERR3200863	34	29	5	4	444975	5.8	0.8	2150481	1713846
ERR3200864	219	184	35	9	437783	5.257143	0.257143	2088355	1676937
ERR3200865	12	5	7	1	527343	0.714286	0.142857	2138751	1629980
ERR3200866	9	0	9	0	623019	0	0	2139893	1539088
ERR3200827	97	86	11	2	521625	7.818182	0.181818	2113121	1606943
ERR3200867	35	25	10	2	415941	2.5	0.2	2155908	1745171
ERR3200868	0	0	0	0	578884	0	0	2100734	1541089
ERR3200869	0	0	0	0	448406	0	0	2152399	1713614
ERR3200870	0	0	0	0	534630	0	0	2118836	1602987
ERR3200871	0	0	0	0	525813	0	0	2132637	1625312
ERR3200872	0	0	0	0	571797	0	0	2172239	1609587
ERR3200873	4253	2065	2188	46	329326	0.943784	0.021024	2140864	1894031
ERR3200874	255	231	24	5	504420	9.625	0.208333	2080927	1608379
ERR3200875	17	0	17	0	371423	0	0	2145687	1786577
ERR3200876	170	168	2	3	391861	84	1.5	2152633	1775458
ERR3200828	10	5	5	1	502548	1	0.2	2145733	1663780
ERR3200877	505	476	29	11	525405	16.413794	0.37931	2111991	1616425
ERR3200878	446	357	89	10	514222	4.011236	0.11236	2144109	1671039
ERR3200879	81	64	17	4	522640	3.764706	0.235294	2110472	1606422
ERR3200880	0	0	0	0	518171	0	0	2105929	1602840
ERR3200881	0	0	0	0	473073	0	0	2132177	1668776
ERR3200882	0	0	0	0	619407	0	0	2135021	1541969
ERR3200883	0	0	0	0	623863	0	0	2131484	1536153
ERR3200884	0	0	0	0	529352	0	0	2114371	1594739
ERR3200885	178	58	120	4	472478	0.483333	0.033333	2129935	1674025
ERR3200886	0	0	0	0	509215	0	0	2136287	1643249
ERR3200829	2	0	2	0	446982	0	0	2122820	1694304
ERR3200888	0	0	0	0	556476	0	0	2109243	1572472
ERR3200889	397	348	49	7	473558	7.102041	0.142857	2089803	1650752
ERR3200890	0	0	0	0	522230	0	0	2112185	1609125
ERR3200891	0	0	0	0	577592	0	0	2139217	1585239
ERR3200892	211	121	90	9	451873	1.344444	0.1	2121365	1685017
ERR3200893	55	24	31	3	484577	0.774194	0.096774	2139091	1670222
ERR3200894	0	0	0	0	511899	0	0	2188519	1680365
ERR3200895	1	0	1	0	511899	0	0	2189319	1680793
ERR3200896	0	0	0	0	486893	0	0	2152596	1673230
ERR3200830	77	66	11	4	396858	6	0.363636	2149475	1771193
ERR3200812	3	0	3	0	468669	0	0	2140491	1678519
ERR3200897	0	0	0	0	522539	0	0	2115353	1612015
ERR3200898	71	36	35	5	555175	1.028571	0.142857	2112820	1584498
ERR3200899	615	568	47	18	501871	12.085107	0.382979	2122784	1688422
ERR3200900	0	0	0	0	518646	0	0	2187037	1674992
ERR3200901	1082	806	276	23	493408	2.92029	0.083333	2135363	1662132
ERR3200902	4	0	4	0	518770	0	0	2105750	1606708
ERR3200903	354	339	15	4	506927	22.6	0.266667	2104877	1624941
ERR3200904	470	309	161	16	418063	1.919255	0.099379	2133667	1770815
ERR3200905	183	30	153	4	420175	0.196078	0.026144	2141540	1735169
ERR3200906	383	335	48	6	623863	6.979167	0.125	2134406	1537648
ERR3200831	0	0	0	0	511559	0	0	2180317	1677978
ERR3200907	647	429	218	17	493688	1.96789	0.077982	2123788	1671954
ERR3200908	20	9	11	2	532808	0.818182	0.181818	2109886	1598353
ERR3200909	0	0	0	0	533018	0	0	2164425	1647617
ERR3200910	100	84	16	5	454808	5.25	0.3125	2149178	1713908
ERR3200911	0	0	0	0	568275	0	0	2120965	1573300
ERR3200912	13	7	6	1	511130	1.166667	0.166667	2133780	1634312
ERR3200913	493	253	240	10	436313	1.054167	0.041667	2137019	1738016
ERR3200914	0	0	0	0	442246	0	0	2087993	1663529
ERR3200915	4	0	4	0	532917	0	0	2107821	1595427
ERR3200916	0	0	0	0	471861	0	0	2130978	1670555
ERR3200832	4	0	4	0	511559	0	0	2180345	1678338
ERR3200917	4	0	4	0	501857	0	0	2186404	1691145
ERR3200918	295	217	78	13	493366	2.782051	0.166667	2090929	1624858
ERR3200919	4	0	4	0	492411	0	0	2138512	1671303
ERR3200920	1351	839	512	28	494399	1.638672	0.054688	2136920	1677614
ERR3200921	0	0	0	0	529150	0	0	2105316	1597218
ERR3200922	9	0	9	0	510539	0	0	2110120	1616172
ERR3200923	558	468	90	23	487475	5.2	0.255556	2121869	1680209
ERR3200924	0	0	0	0	532888	0	0	2107956	1593629
ERR3200925	0	0	0	0	497301	0	0	2136335	1655679
ERR3200926	324	282	42	9	451439	6.714286	0.214286	2088053	1663885
ERR3200833	0	0	0	0	521842	0	0	2118417	1616222
ERR3200927	0	0	0	0	491913	0	0	2142304	1672508
ERR3200928	750	506	244	22	417467	2.073771	0.090164	2139041	1784200
ERR3200929	263	248	15	9	567315	16.533333	0.6	2111891	1584840
ERR3200930	639	485	154	17	445030	3.149351	0.11039	2133904	1723930
ERR3200931	757	647	110	22	564277	5.881818	0.2	2158565	1674357
ERR3200932	0	0	0	0	518171	0	0	2107682	1604769
ERR3200933	1	0	1	0	413739	0	0	2152553	1743939
ERR3200934	120	77	43	5	485029	1.790698	0.116279	2150372	1680918
ERR3200935	58	43	15	4	447756	2.866667	0.266667	2089890	1666236
ERR3200936	2013	1507	506	32	449789	2.978261	0.063241	2144245	1819923
ERR3200834	1	0	1	0	532808	0	0	2108896	1596451
ERR3200937	1	0	1	0	501857	0	0	2184835	1690346
ERR3200938	36	0	36	0	413739	0	0	2150752	1742532
ERR3200939	0	0	0	0	500534	0	0	2104302	1614158
ERR3200940	0	0	0	0	413739	0	0	2149765	1741673
ERR3200941	3	0	3	0	518771	0	0	2109098	1608219
ERR3200942	4	0	4	0	413739	0	0	2148382	1740369
ERR3200943	3	0	3	0	532808	0	0	2101761	1591316
ERR3200944	122	103	19	9	541254	5.421052	0.473684	2108964	1587560
ERR3200945	0	0	0	0	532808	0	0	2105193	1593760
ERR3200946	507	429	78	7	513252	5.5	0.089744	2100110	1614399
ERR3200835	9	0	9	0	482010	0	0	2198068	1722372
ERR3200947	21	8	13	1	619407	0.615385	0.076923	2131660	1539122
ERR3200948	0	0	0	0	486011	0	0	2190271	1712924
ERR3200949	216	187	29	10	533468	6.448276	0.344828	2114255	1607360
ERR3200951	119	97	22	5	491577	4.409091	0.227273	2199727	1714708
ERR3200952	0	0	0	0	409326	0	0	2150680	1756613
ERR3200954	0	0	0	0	537261	0	0	2163434	1643464
ERR3200955	0	0	0	0	566809	0	0	2112605	1580366
ERR3200956	89	41	48	3	527264	0.854167	0.0625	2136229	1629729
ERR3200836	34	26	8	2	417497	3.25	0.25	2151137	1742154
ERR3200957	0	0	0	0	448389	0	0	2153401	1713987
ERR3200958	8	0	8	0	577304	0	0	2132976	1581803
ERR3200959	43	5	38	1	428340	0.131579	0.026316	2134754	1719827
ERR3200960	4	0	4	0	431298	0	0	2147331	1725839
ERR3200961	0	0	0	0	442872	0	0	2151119	1715388
ERR3200962	8	6	2	1	619407	3	0.5	2133588	1541703
ERR3200964	0	0	0	0	431298	0	0	2146302	1725368
ERR3200965	2	0	2	0	533555	0	0	2117898	1605015
ERR3200966	0	0	0	0	532888	0	0	2118050	1603468
ERR3200837	28	0	28	0	498127	0	0	2187829	1697699
ERR3200967	0	0	0	0	485481	0	0	2183068	1707305
ERR3200968	1372	1128	244	25	519212	4.622951	0.102459	2100019	1646432
ERR3200969	0	0	0	0	482989	0	0	2124095	1645879
ERR3200970	0	0	0	0	448389	0	0	2151671	1711090
ERR3200971	9	0	9	0	522119	0	0	2110748	1600140
ERR3200972	2	0	2	0	619407	0	0	2134194	1542401
ERR3200973	306	228	78	13	494301	2.923077	0.166667	2114610	1642283
ERR3200974	0	0	0	0	547416	0	0	2144594	1603586
ERR3200975	0	0	0	0	518171	0	0	2109141	1609749
ERR3200976	0	0	0	0	486389	0	0	2198838	1717067
ERR3200838	17	6	11	1	478677	0.545455	0.090909	2086127	1621840
ERR3200977	5	0	5	0	518769	0	0	2108931	1608357
ERR3200978	0	0	0	0	573507	0	0	2115855	1560970
ERR3200979	12	0	12	0	532071	0	0	2108108	1595552
ERR3200980	92	69	23	8	535437	3	0.347826	2132699	1621447
ERR3200981	914	536	378	27	382913	1.417989	0.071429	2134944	1818250
ERR3200982	281	222	59	7	498704	3.762712	0.118644	2133507	1652201
ERR3200983	0	0	0	0	486546	0	0	2155586	1682911
ERR3200984	178	119	59	10	517831	2.016949	0.169492	2113782	1616854
ERR3200985	2	0	2	0	532888	0	0	2106770	1593261
ERR3200986	15	13	2	2	522586	6.5	1	2110374	1607245
ERR3200839	16	0	16	0	500916	0	0	2109441	1626646
ERR3200987	127	104	23	7	457443	4.521739	0.304348	2148647	1718727
ERR3200988	1	0	1	0	524263	0	0	2115508	1608585
ERR3200989	0	0	0	0	524264	0	0	2111472	1606218
ERR3200990	0	0	0	0	501388	0	0	2179187	1686904
ERR3200991	2	0	2	0	413739	0	0	2151504	1743194
ERR3200992	4	0	4	0	521877	0	0	2111617	1609660
ERR3200993	9	0	9	0	518171	0	0	2108308	1605595
ERR3200994	0	0	0	0	476213	0	0	2172346	1701366
ERR3200995	144	102	42	4	439507	2.428571	0.095238	2088981	1675623
ERR3200996	1140	1079	61	25	602701	17.688524	0.409836	2168020	1602095
ERR3200840	0	0	0	0	527264	0	0	2135326	1629106
ERR3200813	0	0	0	0	389437	0	0	2149281	1773194
ERR3200997	169	153	16	6	522539	9.5625	0.375	2115011	1612366
ERR3200998	53	37	16	2	529968	2.3125	0.125	2134664	1626497
ERR3200999	8	6	2	1	435395	3	0.5	2149653	1719783
ERR3201000	1	0	1	0	528973	0	0	2103023	1596356
ERR3201001	2	0	2	0	445750	0	0	2142604	1706816
ERR3201002	0	0	0	0	445750	0	0	2142606	1708624
ERR3201003	0	0	0	0	511559	0	0	2174919	1673099
ERR3201004	264	235	29	11	571833	8.103448	0.37931	2117752	1592530
ERR3201005	4	0	4	0	413739	0	0	2149410	1741399
ERR3201006	0	0	0	0	556399	0	0	2149802	1605806
ERR3200841	0	0	0	0	537489	0	0	2118480	1598248
ERR3201007	0	0	0	0	528973	0	0	2103656	1595440
ERR3201008	0	0	0	0	384083	0	0	2143837	1768884
ERR3201009	172	146	26	7	446618	5.615385	0.269231	2144701	1723769
ERR3201010	2	0	2	0	556476	0	0	2106543	1570836
ERR3201011	1485	1294	191	32	529201	6.774869	0.167539	2145780	1743919
ERR3201012	25	22	3	2	521341	7.333333	0.666667	2114702	1616054
ERR3201013	0	0	0	0	516899	0	0	2115795	1619132
ERR3201014	0	0	0	0	524263	0	0	2113300	1608082
ERR3201015	0	0	0	0	538009	0	0	2113161	1592770
ERR3201016	1	0	1	0	524925	0	0	2110595	1604761
ERR3200842	1	0	1	0	502548	0	0	2138625	1656339
ERR3201017	34	20	14	3	545392	1.428571	0.214286	2112650	1585020
ERR3201018	52	9	43	2	427694	0.209302	0.046512	2136767	1721630
ERR3201019	0	0	0	0	511950	0	0	2108065	1614395
ERR3201020	0	0	0	0	527333	0	0	2114142	1605651
ERR3200843	1	0	1	0	526686	0	0	2103503	1599708
ERR3200844	70	40	30	4	520806	1.333333	0.133333	2135282	1633998
ERR3200845	8	0	8	0	476496	0	0	2115076	1652367
ERR3200846	141	110	31	9	367018	3.548387	0.290323	2138998	1781996
ERR3200847	8	0	8	0	451763	0	0	2154521	1711312
ERR3200848	0	0	0	0	527188	0	0	2113474	1607701
ERR3200849	0	0	0	0	531264	0	0	2146156	1627993
ERR3200850	13	0	13	0	429058	0	0	2093816	1682334
ERR3200814	1707	1016	691	22	422477	1.470333	0.031838	2143730	1768930
ERR3200851	200	125	75	10	528185	1.666667	0.133333	2115751	1609799
ERR3200852	903	819	84	24	484440	9.75	0.285714	2121769	1705112
ERR3200853	12	8	4	1	528973	2	0.25	2109856	1600999
ERR3200854	895	534	361	20	507495	1.479224	0.055402	2197635	1699100
ERR3200855	120	115	5	5	541128	23	1	2109609	1591961
ERR3200856	72	21	51	2	415892	0.411765	0.039216	2153391	1742613
ERR3200857	1	0	1	0	494207	0	0	2198618	1711114
ERR3200858	721	631	90	17	508280	7.011111	0.188889	2115111	1649975
ERR3200859	6	0	6	0	459322	0	0	2088821	1649380
ERR3200815	0	0	0	0	352555	0	0	2092976	1753524
ERR3200816	734	645	89	16	480826	7.247191	0.179775	2116202	1692484
ERR3200817	2	0	2	0	476496	0	0	2118764	1655968
ERR3200818	2695	1155	1540	25	341910	0.75	0.016234	2096275	1787868
ERR3200819	0	0	0	0	521624	0	0	2113105	1605811
ERR3201021	0	0	0	0	412899	0	0	2143858	1742635
ERR3201022	2	0	2	0	537127	0	0	2126615	1601976
ERR3201023	11	0	11	0	501090	0	0	2176634	1684598
ERR3201024	0	0	0	0	511130	0	0	2130154	1631040
ERR3201025	1	0	1	0	519432	0	0	2108106	1608094
ERR3201026	4	0	4	0	412899	0	0	2140961	1739998
ERR3201027	106	80	26	4	578696	3.076923	0.153846	2177324	1614283
ERR3201028	0	0	0	0	510539	0	0	2111581	1618183
ERR3201029	127	117	10	2	521877	11.7	0.2	2113118	1610695
ERR3201030	10	0	10	0	536845	0	0	2143053	1618425
ERR3201031	0	0	0	0	490212	0	0	2074039	1599506
ERR3201032	132	88	44	6	520222	2	0.136364	2107368	1611313
ERR3201033	0	0	0	0	528692	0	0	2183264	1662084
ERR3201034	2216	1649	567	40	592530	2.908289	0.070547	2085863	1625535
ERR3201035	0	0	0	0	528692	0	0	2184498	1663553
ERR3201036	0	0	0	0	527118	0	0	2115911	1605775
ERR3201037	228	181	47	9	492902	3.851064	0.191489	2170255	1693294
ERR3201038	0	0	0	0	429532	0	0	2141639	1723602
ERR3201039	48	25	23	2	443186	1.086957	0.086957	2146654	1712929
ERR3201040	0	0	0	0	619407	0	0	2129296	1539026
ERR3201041	19	8	11	1	533775	0.727273	0.090909	2111296	1599682
ERR3201042	2	0	2	0	557391	0	0	2178951	1632040
ERR3201043	10	6	4	1	441809	1.5	0.25	2149436	1719301
ERR3201044	8	0	8	0	518171	0	0	2105110	1602886
ERR3201045	0	0	0	0	522232	0	0	2112638	1609506
ERR3201046	319	263	56	10	521859	4.696429	0.178571	2102908	1620474
ERR3201047	18	18	0	2	415941	0	0	2150987	1740910
ERR3201048	8	0	8	0	533550	0	0	2106323	1591831
ERR3201049	393	355	38	7	518133	9.342105	0.184211	2105910	1615801
ERR3201050	0	0	0	0	490390	0	0	2143036	1663760
ERR3201051	1709	1139	570	28	519173	1.998246	0.049123	2106963	1685412
ERR3201052	3177	1798	1379	34	438641	1.303843	0.024656	2167547	1799790
ERR3201053	0	0	0	0	501090	0	0	2179076	1687452
ERR3201054	5	0	5	0	502058	0	0	2107217	1624653
ERR3201055	65	49	16	3	421204	3.0625	0.1875	2148645	1733640
ERR3201056	3	0	3	0	520938	0	0	2179711	1667666
ERR3201057	14	0	14	0	538832	0	0	2111368	1592537
ERR3201058	0	0	0	0	384000	0	0	2147985	1771487
ERR3201059	7	0	7	0	556399	0	0	2146860	1603632
ERR3201060	0	0	0	0	511312	0	0	2113355	1616871
ERR3201061	0	0	0	0	519432	0	0	2107495	1607021
ERR3201062	296	262	34	10	391772	7.705883	0.294118	2147999	1773233
ERR3201063	56	39	17	2	464864	2.294118	0.117647	2089195	1647776
ERR3201064	0	0	0	0	389437	0	0	2144184	1769150
ERR3201065	2	0	2	0	419475	0	0	2130792	1722250
ERR3201066	13	7	6	1	509215	1.166667	0.166667	2129553	1637677
ERR3201067	155	126	29	7	586891	4.344828	0.241379	2096588	1539812
ERR3201068	0	0	0	0	379681	0	0	2134646	1761870
ERR3201069	1731	1410	321	31	565898	4.392523	0.096573	2180260	1709847
ERR3201070	202	161	41	9	513706	3.926829	0.219512	2108075	1617817
ERR3201071	0	0	0	0	510539	0	0	2112566	1618138
ERR3201072	243	200	43	8	656018	4.651163	0.186047	2131912	1532524
ERR3201073	147	118	29	6	542687	4.068965	0.206897	2113899	1600207
ERR3201074	55	30	25	4	558738	1.2	0.16	2148829	1605385
ERR3201075	8	0	8	0	577304	0	0	2134629	1581505
ERR3201076	0	0	0	0	446174	0	0	2146890	1709584
ERR3201077	786	669	117	22	554321	5.717949	0.188034	2111208	1608734
ERR3201078	2234	1588	646	43	457822	2.458204	0.066563	2141720	1802116
ERR3201079	2	0	2	0	532783	0	0	2105530	1594851
ERR3201080	4	0	4	0	476496	0	0	2111044	1649481
ERR3201081	933	838	95	14	475694	8.821053	0.147368	2112467	1686612
ERR3201082	2	0	2	0	507610	0	0	2105656	1612953
ERR3201083	2	0	2	0	560915	0	0	2103296	1564990
ERR3201084	0	0	0	0	494207	0	0	2196304	1709232
ERR3201085	0	0	0	0	494207	0	0	2193292	1706042
ERR3201086	0	0	0	0	538880	0	0	2108446	1587729
ERR3201087	195	178	17	4	448721	10.470589	0.235294	2146914	1716106
ERR3201088	14	9	5	1	537131	1.8	0.2	2131361	1607351
ERR3201089	8	5	3	1	451530	1.666667	0.333333	2151525	1707902
ERR3201090	0	0	0	0	532783	0	0	2108808	1596836
ERR3201091	0	0	0	0	420594	0	0	2154561	1739558
ERR3201092	101	100	1	3	516348	100	3	2138477	1636808
ERR3201093	188	111	77	9	458581	1.441558	0.116883	2091616	1653805
ERR3201094	599	545	54	18	457239	10.092592	0.333333	2090929	1667537
ERR3201095	218	140	78	3	518171	1.794872	0.038462	2107252	1604253
ERR3201096	1029	828	201	14	551863	4.119403	0.069652	2181518	1686491
ERR3201097	6	0	6	0	521668	0	0	2115026	1610012
ERR3201098	313	258	55	13	455043	4.690909	0.236364	2152356	1755366
ERR3201099	0	0	0	0	538170	0	0	2110529	1590640
ERR3201100	311	285	26	4	546773	10.961538	0.153846	2111783	1593846
ERR3201101	10	7	3	1	544468	2.333333	0.333333	2116053	1590182
ERR3201102	128	120	8	4	390001	15	0.5	2149024	1772362
ERR3201103	5	0	5	0	528302	0	0	2116169	1608156
ERR3201104	9	0	9	0	518770	0	0	2109080	1609132
ERR3201105	5	0	5	0	619407	0	0	2131756	1538510
ERR3201106	11	0	11	0	429326	0	0	2131279	1714036
ERR3201107	0	0	0	0	501959	0	0	2175261	1682710
ERR3201108	0	0	0	0	486666	0	0	2112576	1645822
ERR3201109	0	0	0	0	506742	0	0	2163968	1670793
ERR3201110	0	0	0	0	501541	0	0	2183861	1691227
ERR3201111	218	181	37	5	515012	4.891892	0.135135	2109104	1614624
ERR3201112	0	0	0	0	517131	0	0	2111917	1613792
ERR3201113	0	0	0	0	557917	0	0	2182007	1633938
ERR3201114	0	0	0	0	377243	0	0	2118633	1755649
ERR3201115	1	0	1	0	488024	0	0	2195046	1712982
ERR3201116	679	611	68	18	529355	8.985294	0.264706	2103948	1622876
ERR3201117	0	0	0	0	431141	0	0	2142999	1721747
ERR3201118	0	0	0	0	458121	0	0	2139007	1697390
ERR3201119	2	0	2	0	519448	0	0	2109556	1607804
ERR3201120	18	0	18	0	533328	0	0	2104735	1591222
ERR3201121	393	344	49	6	390420	7.020408	0.122449	2122586	1759027
ERR3201122	4	0	4	0	518171	0	0	2110577	1607698
ERR3201123	2	0	2	0	417663	0	0	2148517	1740093
ERR3201124	56	48	8	3	421204	6	0.375	2152581	1741870
ERR3201125	0	0	0	0	521570	0	0	2108493	1606586
ERR3201126	574	513	61	15	552002	8.409836	0.245902	2113748	1595987
ERR3201127	9	0	9	0	557098	0	0	2116961	1579551
ERR3201128	0	0	0	0	534846	0	0	2112157	1595808
ERR3201129	0	0	0	0	471861	0	0	2137308	1676256
ERR3201130	78	43	35	3	535472	1.228571	0.085714	2116181	1601449
ERR3201131	34	26	8	2	526818	3.25	0.25	2133561	1626526
ERR3201132	8	8	0	1	540857	0	0	2119084	1597369
ERR3201133	4	0	4	0	519541	0	0	2113149	1613043
ERR3201134	1	0	1	0	448406	0	0	2155433	1716402
ERR3201135	3	0	3	0	518171	0	0	2111305	1608073
ERR3201136	0	0	0	0	519448	0	0	2108968	1607157
ERR3201137	464	371	93	21	485052	3.989247	0.225806	2156825	1707526
ERR3201138	12	0	12	0	389437	0	0	2147599	1772760
ERR3201139	0	0	0	0	528996	0	0	2108349	1597451
ERR3201140	0	0	0	0	510539	0	0	2115448	1620029
ERR3201141	5	0	5	0	519545	0	0	2113089	1615539
ERR3201142	310	283	27	13	552599	10.481482	0.481481	2129779	1624682
ERR3201143	0	0	0	0	578573	0	0	2115618	1558040
ERR3201144	0	0	0	0	483240	0	0	2115175	1646625
ERR3201145	49	29	20	2	537489	1.45	0.1	2111227	1593363
ERR3201146	0	0	0	0	451763	0	0	2154176	1710254
ERR3201147	0	0	0	0	525813	0	0	2131133	1622967
ERR3201148	243	168	75	11	545999	2.24	0.146667	2117902	1592647
ERR3201149	0	0	0	0	518171	0	0	2104548	1602188
ERR3201150	1130	790	340	23	522081	2.323529	0.067647	2149073	1671610
ERR3201151	0	0	0	0	446982	0	0	2122363	1693527
ERR3201152	106	93	13	5	536643	7.153846	0.384615	2111523	1599375
ERR3201153	27	16	11	1	518172	1.454545	0.090909	2097664	1597143
ERR3201154	56	13	43	2	455143	0.302326	0.046512	2079318	1638255
ERR3201155	3	0	3	0	416946	0	0	2145816	1739768
ERR3201156	40	10	30	2	501090	0.333333	0.066667	2182068	1689783
ERR3201157	0	0	0	0	488024	0	0	2198992	1717000
ERR3201158	0	0	0	0	532808	0	0	2104971	1594374
ERR3201159	11	0	11	0	415941	0	0	2148952	1738657
ERR3201160	1	0	1	0	487816	0	0	2198914	1716947
ERR3201161	12	0	12	0	506089	0	0	2139446	1653584
ERR3201162	0	0	0	0	429326	0	0	2130718	1713966
ERR3201163	902	773	129	21	566398	5.992248	0.162791	2107894	1576361
ERR3201164	0	0	0	0	528692	0	0	2186764	1665271
ERR3201165	15	5	10	1	510539	0.5	0.1	2113169	1617484
ERR3201166	378	325	53	15	518140	6.132075	0.283019	2171287	1677091
ERR3201167	1	0	1	0	502058	0	0	2112941	1629597
ERR3201168	8	0	8	0	619407	0	0	2131617	1538864
ERR3201169	240	201	39	11	553984	5.153846	0.282051	2146087	1606303
ERR3201170	0	0	0	0	476496	0	0	2109259	1647715
ERR3201171	773	755	18	7	583025	41.944443	0.388889	2110769	1560264
ERR3201172	64	50	14	3	393705	3.571429	0.214286	2147837	1772826
ERR3201173	0	0	0	0	518879	0	0	2115056	1614984
ERR3201174	4	0	4	0	451117	0	0	2148938	1706328
ERR3201175	0	0	0	0	442802	0	0	2090608	1668126
ERR3201176	32	21	11	3	558183	1.909091	0.272727	2111661	1571944
ERR3201177	6	0	6	0	488024	0	0	2195761	1713730
ERR3201178	0	0	0	0	428586	0	0	2149038	1730447
ERR3201179	0	0	0	0	543230	0	0	2132567	1609562
ERR3201180	0	0	0	0	393049	0	0	2145003	1766973
ERR3201181	256	174	82	9	453081	2.121951	0.109756	2085484	1652383
ERR3201182	0	0	0	0	499598	0	0	2191051	1696385
ERR3201183	57	33	24	4	492561	1.375	0.166667	2138188	1669268
ERR3201283	0	0	0	0	477588	0	0	2119169	1654534
ERR3201284	119	93	26	5	443543	3.576923	0.192308	2155972	1724166
ERR3201285	0	0	0	0	538009	0	0	2116559	1594683
ERR3201286	0	0	0	0	449036	0	0	2156474	1716432
ERR3201287	509	386	123	14	411541	3.138211	0.113821	2064984	1673716
ERR3201288	8	0	8	0	419475	0	0	2134456	1726776
ERR3201289	0	0	0	0	413739	0	0	2156127	1748233
ERR3201290	407	283	124	11	586064	2.282258	0.08871	2102069	1558694
ERR3201291	1190	947	243	23	550777	3.897119	0.09465	2133277	1649850
ERR3201292	0	0	0	0	529379	0	0	2119496	1607933
ERR3201193	184	170	14	9	464268	12.142858	0.642857	2158500	1718031
ERR3201293	142	120	22	7	496386	5.454545	0.318182	2124782	1643926
ERR3201294	0	0	0	0	557391	0	0	2183070	1635675
ERR3201295	275	262	13	6	492955	20.153847	0.461538	2139093	1679427
ERR3201296	1253	1163	90	26	572944	12.922222	0.288889	2118863	1609099
ERR3201297	0	0	0	0	442898	0	0	2156094	1721356
ERR3201298	4	0	4	0	619407	0	0	2137896	1544639
ERR3201299	8	7	1	1	521877	7	1	2116255	1612866
ERR3201300	0	0	0	0	518461	0	0	2114454	1612564
ERR3201301	0	0	0	0	532609	0	0	2153246	1626920
ERR3201302	2	0	2	0	521570	0	0	2119010	1613993
ERR3201194	0	0	0	0	389437	0	0	2157201	1777192
ERR3201303	539	229	310	4	346438	0.73871	0.012903	2129980	1803082
ERR3201304	340	282	58	14	472545	4.862069	0.241379	2151356	1708875
ERR3201305	10	0	10	0	371423	0	0	2146949	1787972
ERR3201306	0	0	0	0	484481	0	0	2145541	1676377
ERR3201307	0	0	0	0	451530	0	0	2157006	1713245
ERR3201308	576	434	142	20	580557	3.056338	0.140845	2153724	1628536
ERR3201309	0	0	0	0	497326	0	0	2143696	1662132
ERR3201310	14	0	14	0	415941	0	0	2156024	1746047
ERR3201311	6	0	6	0	492411	0	0	2142231	1673950
ERR3201312	0	0	0	0	492649	0	0	2138003	1670895
ERR3201195	11	0	11	0	486108	0	0	2148720	1676080
ERR3201313	13	0	13	0	422482	0	0	2139482	1726940
ERR3201314	1	0	1	0	473060	0	0	2137669	1674482
ERR3201315	1	0	1	0	473060	0	0	2141799	1677020
ERR3201316	0	0	0	0	360798	0	0	2132685	1788849
ERR3201317	27	14	13	2	468669	1.076923	0.153846	2144001	1681732
ERR3201318	227	37	190	4	431357	0.194737	0.021053	2138694	1723412
ERR3201319	67	60	7	1	537863	8.571428	0.142857	2119526	1597505
ERR3201320	66	18	48	2	548501	0.375	0.041667	2115265	1586019
ERR3201321	601	583	18	8	492932	32.388889	0.444444	2191957	1713507
ERR3201322	0	0	0	0	398790	0	0	2136978	1748940
ERR3201196	7	0	7	0	623019	0	0	2140127	1540070
ERR3201323	0	0	0	0	556476	0	0	2115179	1575976
ERR3201324	0	0	0	0	507610	0	0	2107498	1613991
ERR3201325	0	0	0	0	525374	0	0	2119699	1611540
ERR3201326	1	0	1	0	525813	0	0	2136241	1628962
ERR3201327	0	0	0	0	525012	0	0	2104116	1602057
ERR3201328	0	0	0	0	538980	0	0	2117619	1597172
ERR3201329	208	179	29	8	448811	6.172414	0.275862	2154359	1726342
ERR3201330	19	0	19	0	484416	0	0	2146931	1678305
ERR3201331	0	0	0	0	462125	0	0	2097265	1654351
ERR3201332	0	0	0	0	521570	0	0	2116081	1611669
ERR3201197	125	119	6	3	626880	19.833334	0.5	2140812	1539893
ERR3201333	1	0	1	0	558770	0	0	2118337	1578685
ERR3201334	0	0	0	0	536083	0	0	2113909	1592129
ERR3201335	427	413	14	7	459776	29.5	0.5	2158526	1717870
ERR3201336	0	0	0	0	518463	0	0	2106733	1605218
ERR3201337	1190	1105	85	29	542308	13	0.341176	2118055	1640109
ERR3201338	77	55	22	3	426163	2.5	0.136364	2156630	1744249
ERR3201339	48	28	20	2	416946	1.4	0.1	2151853	1745708
ERR3201340	0	0	0	0	520938	0	0	2186063	1674011
ERR3201341	0	0	0	0	524145	0	0	2186346	1671975
ERR3201342	0	0	0	0	627290	0	0	2142363	1536194
ERR3201198	0	0	0	0	508174	0	0	2188871	1689222
ERR3201343	0	0	0	0	557801	0	0	2116181	1575750
ERR3201344	117	100	17	3	486721	5.882353	0.176471	2180342	1708826
ERR3201345	0	0	0	0	524145	0	0	2185671	1671699
ERR3201346	5	5	0	1	497323	0	0	2143125	1661905
ERR3201347	0	0	0	0	549288	0	0	2114483	1585542
ERR3201348	139	88	51	7	558540	1.72549	0.137255	2153972	1610032
ERR3201349	4	0	4	0	478475	0	0	2155623	1684575
ERR3201350	27	21	6	3	488024	3.5	0.5	2197922	1715494
ERR3201351	26	15	11	2	538384	1.363636	0.181818	2113048	1591040
ERR3201352	1	0	1	0	486893	0	0	2155264	1675881
ERR3201199	0	0	0	0	483240	0	0	2119106	1649462
ERR3201353	1	0	1	0	524145	0	0	2186142	1672289
ERR3201354	418	377	41	16	473314	9.195122	0.390244	2157115	1716380
ERR3201355	0	0	0	0	497590	0	0	2114226	1628527
ERR3201356	92	81	11	3	548871	7.363636	0.272727	2111205	1583332
ERR3201357	0	0	0	0	537127	0	0	2130951	1606194
ERR3201358	511	486	25	13	508642	19.440001	0.52	2193196	1697474
ERR3201359	3	0	3	0	501541	0	0	2183129	1690410
ERR3201360	9	0	9	0	431141	0	0	2147305	1725390
ERR3201361	190	140	50	10	533124	2.8	0.2	2112308	1614590
ERR3201362	0	0	0	0	502548	0	0	2148925	1667020
ERR3201200	0	0	0	0	580749	0	0	2139543	1581923
ERR3201363	201	61	140	4	434304	0.435714	0.028571	2140760	1725623
ERR3201364	126	64	62	5	485925	1.032258	0.080645	2136298	1661704
ERR3201365	30	15	15	2	487816	1	0.133333	2198834	1717243
ERR3201366	0	0	0	0	533869	0	0	2107741	1593316
ERR3201367	134	100	34	6	525804	2.941176	0.176471	2133886	1628411
ERR3201369	0	0	0	0	486108	0	0	2146361	1673643
ERR3201370	0	0	0	0	574702	0	0	2181286	1617762
ERR3201371	76	37	39	2	492411	0.948718	0.051282	2134570	1668012
ERR3201372	696	616	80	18	531479	7.7	0.225	2179950	1691365
ERR3201201	0	0	0	0	456916	0	0	2122731	1680846
ERR3201373	3	0	3	0	510539	0	0	2119338	1622770
ERR3201374	5	0	5	0	510889	0	0	2109777	1618176
ERR3201202	0	0	0	0	575811	0	0	2115919	1565433
ERR3201184	0	0	0	0	506089	0	0	2148044	1661036
ERR3201203	79	65	14	3	535184	4.642857	0.214286	2118842	1602008
ERR3201204	0	0	0	0	459467	0	0	2158965	1707255
ERR3201205	0	0	0	0	485831	0	0	2128265	1647240
ERR3201206	0	0	0	0	417663	0	0	2154426	1745007
ERR3201207	0	0	0	0	428157	0	0	2142173	1723809
ERR3201208	101	75	26	4	519125	2.884615	0.153846	2112451	1611455
ERR3201209	2	0	2	0	566782	0	0	2123094	1574672
ERR3201210	0	0	0	0	566779	0	0	2121243	1573219
ERR3201211	31	10	21	2	537844	0.47619	0.095238	2117358	1597269
ERR3201212	8	7	1	1	519236	7	1	2122791	1619999
ERR3201185	0	0	0	0	537864	0	0	2119684	1598989
ERR3201213	0	0	0	0	522334	0	0	2119694	1614752
ERR3201214	165	124	41	8	450644	3.02439	0.195122	2156028	1724744
ERR3201215	13	0	13	0	499598	0	0	2184322	1689074
ERR3201216	0	0	0	0	394072	0	0	2171593	1785923
ERR3201217	329	325	4	7	530867	81.25	1.75	2113626	1606678
ERR3201218	0	0	0	0	459322	0	0	2089211	1650220
ERR3201219	1197	926	271	29	529175	3.416974	0.107011	2145518	1653033
ERR3201220	38	27	11	2	442872	2.454545	0.181818	2157795	1722620
ERR3201221	63	39	24	5	545392	1.625	0.208333	2119057	1592773
ERR3201222	0	0	0	0	508174	0	0	2187914	1688262
ERR3201186	7	0	7	0	524037	0	0	2137062	1629649
ERR3201223	18	0	18	0	455119	0	0	2089548	1647333
ERR3201224	7	7	0	1	446982	0	0	2124633	1695839
ERR3201225	6	0	6	0	532734	0	0	2115953	1602234
ERR3201226	0	0	0	0	429058	0	0	2091957	1680350
ERR3201227	387	338	49	14	408502	6.897959	0.285714	2137895	1767849
ERR3201228	60	33	27	1	517486	1.222222	0.037037	2123281	1622966
ERR3201229	0	0	0	0	520938	0	0	2184901	1672639
ERR3201230	244	203	41	5	536329	4.95122	0.121951	2123917	1608664
ERR3201231	0	0	0	0	472793	0	0	2148092	1692353
ERR3201232	0	0	0	0	561270	0	0	2113119	1572349
ERR3201187	4	0	4	0	413739	0	0	2156832	1748464
ERR3201233	0	0	0	0	580749	0	0	2140436	1582116
ERR3201234	0	0	0	0	416946	0	0	2153033	1745352
ERR3201235	830	704	126	24	648158	5.587302	0.190476	2139417	1543319
ERR3201236	107	60	47	6	451087	1.276596	0.12766	2129417	1702058
ERR3201237	0	0	0	0	626880	0	0	2143591	1542632
ERR3201238	0	0	0	0	619407	0	0	2140764	1547208
ERR3201239	0	0	0	0	437859	0	0	2091221	1669756
ERR3201240	1	0	1	0	437859	0	0	2087466	1666084
ERR3201241	0	0	0	0	453645	0	0	2157513	1711428
ERR3201242	3216	1390	1826	33	288037	0.761227	0.018072	2160002	1945917
ERR3201188	0	0	0	0	417302	0	0	2158164	1748946
ERR3201243	41	21	20	2	484444	1.05	0.1	2147600	1677774
ERR3201244	20	0	20	0	455119	0	0	2088614	1647009
ERR3201245	19	16	3	1	627291	5.333333	0.333333	2147068	1540595
ERR3201246	0	0	0	0	519656	0	0	2169329	1661419
ERR3201247	63	31	32	3	445856	0.96875	0.09375	2152846	1716921
ERR3201248	280	222	58	9	489610	3.827586	0.155172	2183789	1706175
ERR3201249	0	0	0	0	412899	0	0	2145652	1747509
ERR3201250	631	603	28	15	569226	21.535715	0.535714	2120622	1580171
ERR3201251	83	70	13	2	519234	5.384615	0.153846	2119681	1619774
ERR3201252	97	67	30	5	539116	2.233333	0.166667	2143980	1630042
ERR3201189	7	0	7	0	431141	0	0	2150433	1728169
ERR3201253	0	0	0	0	540853	0	0	2123939	1600034
ERR3201254	124	121	3	3	449796	40.333332	1	2159379	1718636
ERR3201255	0	0	0	0	520938	0	0	2187382	1674990
ERR3201257	1	0	1	0	412899	0	0	2152721	1749605
ERR3201258	1	0	1	0	579233	0	0	2122777	1563359
ERR3201259	4	0	4	0	521568	0	0	2119474	1615266
ERR3201260	1448	1295	153	36	507707	8.464052	0.235294	2120574	1685288
ERR3201261	0	0	0	0	487816	0	0	2202549	1719872
ERR3201262	0	0	0	0	417663	0	0	2156692	1747411
ERR3201190	0	0	0	0	511558	0	0	2117549	1624510
ERR3201263	0	0	0	0	508174	0	0	2183116	1682788
ERR3201264	61	50	11	5	538855	4.545455	0.454545	2115340	1601725
ERR3201265	12	0	12	0	510539	0	0	2119927	1623212
ERR3201266	0	0	0	0	497315	0	0	2145978	1663059
ERR3201267	4	0	4	0	577304	0	0	2146652	1590386
ERR3201268	0	0	0	0	512220	0	0	2116377	1618118
ERR3201269	0	0	0	0	451667	0	0	2127927	1691510
ERR3201270	0	0	0	0	492411	0	0	2144869	1676002
ERR3201271	65	27	38	3	403480	0.710526	0.078947	2152659	1757816
ERR3201272	2	0	2	0	573336	0	0	2117935	1564603
ERR3201191	0	0	0	0	531382	0	0	2153483	1632754
ERR3201273	0	0	0	0	476308	0	0	2200956	1730023
ERR3201274	2	0	2	0	573336	0	0	2115596	1562622
ERR3201275	19	5	14	1	509177	0.357143	0.071429	2143753	1659180
ERR3201276	206	172	34	6	511774	5.058824	0.176471	2117891	1619898
ERR3201277	31	27	4	1	537127	6.75	0.25	2137049	1611275
ERR3201279	9	5	4	1	538383	1.25	0.25	2115335	1592771
ERR3201280	57	16	41	2	468685	0.390244	0.04878	2117397	1659869
ERR3201281	0	0	0	0	533532	0	0	2110187	1597970
ERR3201282	722	629	93	17	438830	6.763441	0.182796	2110150	1688743
ERR3201192	141	130	11	3	625493	11.818182	0.272727	2143184	1548635
